State,District,Literate,Male_Literate,Female_Literate,Below_Primary_Education,Primary_Education,Middle_Education,Secondary_Education,Higher_Education,Graduate_Education,Other_Education,Literate_Education,Total_Education
JAMMU AND KASHMIR,Kupwara,439654,282823,156831,60616,101642,99947,74948,39709,21751,6402,405015,694780
JAMMU AND KASHMIR,Badgam,335649,207741,127908,68336,80862,83141,66459,41367,27950,6857,374972,717618
JAMMU AND KASHMIR,Leh(Ladakh),93770,62834,30936,10452,15181,17900,16265,8923,6197,575,75493,108130
JAMMU AND KASHMIR,Kargil,86236,56301,29935,12732,19083,20874,16938,9826,3077,408,82938,122792
JAMMU AND KASHMIR,Punch,261724,163333,98391,55762,72024,69219,46062,29517,13962,1884,288430,452474
JAMMU AND KASHMIR,Rajouri,364109,224469,139640,70996,91859,108785,65921,35804,18576,3036,394977,637283
JAMMU AND KASHMIR,Kathua,389204,228499,160705,69396,82715,106411,91522,47694,24330,4504,426572,607869
JAMMU AND KASHMIR,Baramula,545149,337170,207979,76778,117000,137510,107837,57932,48285,9708,555050,905169
JAMMU AND KASHMIR,Bandipore,185979,117058,68921,34064,47240,48849,35630,18644,12721,2268,199416,363064
JAMMU AND KASHMIR,Srinagar,748584,431746,316838,88911,173309,178723,176409,132727,121856,32114,904049,1214274
JAMMU AND KASHMIR,Ganderbal,143276,90581,52695,25817,38735,38375,28247,15005,9633,2212,158024,274758
JAMMU AND KASHMIR,Pulwama,293958,178326,115632,36201,54808,73991,67368,40931,31286,5897,310482,500851
JAMMU AND KASHMIR,Shupiyan,136500,80355,56145,26468,29593,36939,28617,16501,10782,2010,150910,257963
JAMMU AND KASHMIR,Anantnag,545532,324417,221115,73719,99059,129174,97121,52407,41570,9160,502210,839475
JAMMU AND KASHMIR,Kulgam,209085,125052,84033,36066,47268,60470,45383,24214,18240,3190,234831,410030
JAMMU AND KASHMIR,Doda,219083,138620,80463,43794,47350,62719,48359,31416,12647,1846,248131,411696
JAMMU AND KASHMIR,Ramban,124065,82938,41127,33971,35284,35115,22591,13331,4923,1498,146713,288525
JAMMU AND KASHMIR,Kishtwar,107506,68700,38806,25022,25675,27745,19550,14521,5438,2529,120480,221646
JAMMU AND KASHMIR,Udhampur,322354,197543,124811,58567,80129,86008,55024,29657,17345,4030,330760,525598
JAMMU AND KASHMIR,Reasi,150542,93937,56605,33411,40215,36184,24066,14064,4733,575,153248,296541
JAMMU AND KASHMIR,Jammu,1137135,641916,495219,135391,185962,253542,261852,159257,146501,30616,1173121,1441400
JAMMU AND KASHMIR,Samba,228139,130312,97827,29138,41233,59931,61407,30503,14055,2600,238867,304510
HIMACHAL PRADESH,Chamba,323842,186064,137778,56272,96789,67653,64515,40440,15506,3252,344427,499002
HIMACHAL PRADESH,Kangra,1152640,606443,546197,127699,243617,223099,284124,192936,91236,13577,1176288,1448180
HIMACHAL PRADESH,Lahul AND Spiti,21845,12897,8948,3776,5042,4011,3934,3557,2378,119,22817,29332
HIMACHAL PRADESH,Kullu,307672,174550,133122,48384,77363,61854,58122,39081,23168,2377,310349,413485
HIMACHAL PRADESH,Mandi,723747,393669,330078,100052,159043,132147,180188,128549,54139,9350,763468,982038
HIMACHAL PRADESH,Hamirpur,358091,180555,177536,37327,71107,72114,91184,64363,35620,5263,376978,449529
HIMACHAL PRADESH,Una,399715,213281,186434,51838,87913,81256,105204,60626,32120,5511,424468,512203
HIMACHAL PRADESH,Bilaspur,287620,155599,132021,35817,59489,53515,64730,45695,25474,3241,287961,353825
HIMACHAL PRADESH,Solan,428578,244372,184206,50331,89407,83992,95232,59363,36803,8280,423408,527492
HIMACHAL PRADESH,Sirmaur,362645,205617,157028,57853,100123,78103,67080,38282,23352,4048,368841,509327
HIMACHAL PRADESH,Shimla,612642,342846,269796,69967,113536,113305,141490,95341,80414,9748,623801,761377
HIMACHAL PRADESH,Kinnaur,60699,36697,24002,9400,13749,11437,11140,7871,5118,713,59428,76372
PUNJAB,Gurdaspur,1634719,907660,727059,180897,315156,290618,372317,243539,104345,22107,1528979,2006999
PUNJAB,Kapurthala,576567,316254,260313,71698,127031,112774,128828,77442,48221,9501,575495,750490
PUNJAB,Jalandhar,1622537,882581,739956,183441,333736,304652,339758,216646,162965,34576,1575774,1963583
PUNJAB,Hoshiarpur,1199699,637927,561772,143871,256127,238975,301435,176013,93618,17427,1227466,1522189
PUNJAB,Shahid Bhagat Singh Nagar,438459,239155,199304,53709,111242,94286,101970,61643,26893,5703,455446,588721
PUNJAB,Fatehgarh Sahib,426033,238696,187337,51897,102257,83931,95073,59555,34990,4607,432310,574624
PUNJAB,Ludhiana,2560225,1428348,1131877,277247,488129,443759,527568,318876,272280,44240,2372099,3004079
PUNJAB,Moga,627889,348549,279340,98764,158812,116716,128693,85642,37417,11956,638000,944336
PUNJAB,Firozpur,1227511,707070,520441,196971,306838,226433,221806,147698,82448,25734,1207928,1922797
PUNJAB,Muktsar,524848,300401,224447,90240,137470,101852,104682,62612,36905,10666,544427,885313
PUNJAB,Faridkot,381285,215767,165518,53734,89433,71178,75419,48360,29838,5790,373752,578647
PUNJAB,Bathinda,844868,488261,356607,117795,182796,145626,163928,96329,70240,16666,793380,1231909
PUNJAB,Mansa,423560,244037,179523,75708,106162,84553,85953,48663,27461,5658,434158,745671
PUNJAB,Patiala,1266791,711052,555739,173890,283837,239609,256826,157435,141947,27272,1280816,1799588
PUNJAB,Amritsar,1684770,932981,751789,197944,313874,283819,328229,203656,142399,15879,1485800,2025810
PUNJAB,Tarn Taran,666162,376427,289735,106878,165659,118366,147856,83290,21322,5077,648448,1030327
PUNJAB,Rupnagar,502731,278534,224197,53005,107715,98135,116836,68794,38823,9388,492696,616796
PUNJAB,Sahibzada Ajit Singh Nagar,736575,409944,326631,82178,131983,119930,147214,96568,105306,13103,696282,868508
PUNJAB,Sangrur,1002077,570413,431664,163251,250833,197901,220210,130155,73636,18393,1054379,1624482
PUNJAB,Barnala,359831,201999,157832,49367,90971,66695,81545,43467,23657,4665,360367,572755
CHANDIGARH,Chandigarh,805438,465346,340092,80406,118667,114209,124707,98786,174528,20188,731491,915756
UTTARAKHAND,Uttarkashi,215126,128237,86889,43442,46625,47640,30901,24989,18882,981,213460,297356
UTTARAKHAND,Chamoli,280556,155395,125161,47447,68435,67519,47703,32557,27168,2367,293196,355146
UTTARAKHAND,Rudraprayag,170933,91803,79130,30562,50288,44605,28916,21131,15096,440,191038,236466
UTTARAKHAND,Tehri Garhwal,407994,227406,180588,72163,103462,95417,74008,58434,30704,2073,436261,569274
UTTARAKHAND,Dehradun,1259506,702216,557290,142130,236027,240639,206730,187700,247622,26644,1287492,1584030
UTTARAKHAND,Garhwal,494889,262148,232741,91101,107794,111671,95590,74219,52076,5638,538089,661160
UTTARAKHAND,Pithoragarh,345550,189623,155927,63591,87585,90983,56591,42086,28375,2237,371448,459484
UTTARAKHAND,Bageshwar,179483,97546,81937,38113,47788,50340,31224,20785,10900,675,199825,249364
UTTARAKHAND,Almora,436497,231604,204893,90864,120029,115810,76148,53026,37742,2263,495882,605438
UTTARAKHAND,Champawat,177726,102015,75711,36127,48093,45766,23610,18360,15110,1317,188383,250812
UTTARAKHAND,Nainital,696500,385779,310721,90915,155681,157875,115317,98851,89101,6200,713940,880513
UTTARAKHAND,Udham Singh Nagar,1037839,598525,439314,179602,302653,232381,169274,113661,111062,11786,1120419,1559017
UTTARAKHAND,Hardwar,1178354,691411,486943,245515,336790,243719,165003,114114,134182,29377,1268700,1849670
HARYANA,Panchkula,405318,229862,175456,45607,73584,60177,69163,48306,83256,8466,388559,507781
HARYANA,Ambala,818025,461288,356737,89558,170110,161844,163544,97980,91472,18727,793235,1015266
HARYANA,Yamunanagar,832457,474793,357664,107222,194654,164652,159311,99170,82532,18666,826207,1145635
HARYANA,Kurukshetra,646893,370828,276065,94530,145392,118107,120790,81964,71007,10999,642789,909427
HARYANA,Kaithal,646529,385782,260747,119345,158239,124682,117753,82297,51043,9111,662470,1032339
HARYANA,Karnal,978013,564516,413497,155839,231354,188040,183590,124790,101387,19186,1004186,1433406
HARYANA,Panipat,786599,464136,322463,118873,170565,143466,141473,91756,75774,10977,752884,1049096
HARYANA,Sonipat,998316,589881,408435,138489,200458,182396,224639,150760,101186,19261,1017189,1362002
HARYANA,Jind,832758,502049,330709,136892,185626,151682,154773,107994,64599,14277,815843,1235467
HARYANA,Fatehabad,557578,327471,230107,103541,136663,99948,93526,61476,37741,9504,542399,886933
HARYANA,Sirsa,782897,456968,325929,141766,201349,153263,134559,83373,61620,16698,792628,1204981
HARYANA,Hisar,1114311,670200,444111,197303,230074,194595,202792,144626,105346,19031,1093767,1599018
HARYANA,Bhiwani,1069871,643158,426713,186145,223049,198307,218631,148995,104875,13786,1093788,1553152
HARYANA,Rohtak,747582,436025,311557,117097,150903,140782,168499,109596,100346,21134,808357,1057152
HARYANA,Jhajjar,676091,399480,276611,90737,109829,115794,145258,97457,58826,9387,627288,828316
HARYANA,Mahendragarh,630255,380440,249815,94273,135849,126291,132765,94245,60296,10353,654072,899674
HARYANA,Rewari,636947,375453,261494,81280,120860,122617,139646,95807,65143,9820,635173,842000
HARYANA,Gurgaon,1111116,638666,472450,126920,177453,175370,219200,150120,233402,41366,1123831,1387551
HARYANA,Mewat,454897,308435,146462,125261,135842,67299,41836,22265,12453,5527,410483,1029767
HARYANA,Faridabad,1272739,734940,537799,137902,220384,198551,282666,178846,259933,27864,1306146,1652713
HARYANA,Palwal,599796,379696,220100,125474,142156,113940,102626,65963,43780,8373,602312,996137
NCT OF DELHI,North West,2707855,1541952,1165903,228507,571255,607092,613393,519808,465677,22436,3028168,3444888
NCT OF DELHI,North,681517,381615,299902,58952,133915,142788,126121,97744,107099,11098,677717,802994
NCT OF DELHI,North East,1611588,912481,699107,206524,500493,488767,341540,212438,122983,9199,1881944,2139910
NCT OF DELHI,East,1352998,748382,604616,86484,219061,260094,267825,235187,246988,18644,1334283,1503976
NCT OF DELHI,New Delhi,114179,65678,48501,4641,11728,15326,15942,17742,23934,2186,91499,101597
NCT OF DELHI,Central,442360,240518,201842,34122,80924,96755,83244,62124,80251,6097,443517,530803
NCT OF DELHI,West,1961179,1093933,867246,157606,318376,365913,369114,327114,440295,54376,2032794,2340933
NCT OF DELHI,South West,1787689,1025261,762428,152945,255177,313817,335645,308513,400800,47723,1814620,2093452
NCT OF DELHI,South,2078402,1185036,893366,191659,368772,400595,430091,354078,458858,52503,2256556,2584843
RAJASTHAN,Ganganagar,1193343,710908,482435,237042,314107,238397,163098,105734,104071,19396,1181845,1892068
RAJASTHAN,Hanumangarh,1034136,624281,409855,239601,273441,219194,153628,104087,84185,14416,1088552,1812006
RAJASTHAN,Bikaner,1278801,782399,496402,410155,333211,254335,143669,80296,101714,18577,1341957,2357288
RAJASTHAN,Churu,1149269,696729,452540,336671,302022,237220,161520,100677,77282,13320,1228712,2138938
RAJASTHAN,Jhunjhunun,1370360,815834,554526,296093,305626,301866,256621,192240,158936,25286,1536668,2249252
RAJASTHAN,Alwar,2182476,1359829,822647,492781,492981,468628,324050,230415,222622,31390,2262867,3647772
RAJASTHAN,Bharatpur,1480869,943910,536959,363676,330336,314953,211938,147520,132571,23311,1524305,2629129
RAJASTHAN,Dhaulpur,683098,435721,247377,207566,172914,132964,77360,45590,37856,8194,682444,1234550
RAJASTHAN,Karauli,805849,531904,273945,220644,193938,170399,104208,69443,67639,14402,840673,1509599
RAJASTHAN,Sawai Madhopur,741748,486184,255564,205450,172925,151108,87349,57625,70870,14384,759711,1346203
RAJASTHAN,Dausa,938051,596935,341116,229035,235474,208537,135234,92559,90833,13764,1005436,1687416
RAJASTHAN,Jaipur,4300965,2554793,1746172,819004,875940,823570,659389,455527,703673,96562,4433665,6479703
RAJASTHAN,Sikar,1652117,995275,656842,369959,438872,367412,282595,200430,181282,19321,1859871,2827368
RAJASTHAN,Nagaur,1758624,1102750,655874,513871,486057,388822,242053,147701,117444,14853,1910801,3443938
RAJASTHAN,Jodhpur,2031532,1265753,765779,497762,512035,405132,259304,154789,177199,30720,2036941,3628898
RAJASTHAN,Jaisalmer,308653,210415,98238,109484,71132,41264,20142,12759,10604,1720,267105,664754
RAJASTHAN,Barmer,1188322,783461,404861,406804,352636,219932,101291,52272,39533,7328,1179796,2681654
RAJASTHAN,Jalor,829582,543923,285659,270997,277152,181691,75304,32366,25210,7850,870570,1904104
RAJASTHAN,Sirohi,476806,309900,166906,117971,147381,110385,58213,30724,27076,5251,497001,1074093
RAJASTHAN,Pali,1085693,667381,418312,293818,359329,271312,144581,71472,67021,9403,1216936,2199986
RAJASTHAN,Ajmer,1526673,926268,600405,379043,394576,313680,200191,130608,172683,28138,1618919,2653253
RAJASTHAN,Tonk,749659,478329,271330,237191,190750,154825,91853,64431,67155,9919,816124,1478026
RAJASTHAN,Bundi,585044,371705,213339,153500,159218,121104,63248,41227,41052,6460,585809,1139431
RAJASTHAN,Bhilwara,1256126,777582,478544,398993,338296,258990,141250,92785,106667,10928,1347909,2528365
RAJASTHAN,Rajsamand,619139,383334,235805,190090,190388,140839,72969,41063,34286,4732,674367,1218884
RAJASTHAN,Dungarpur,681591,415820,265771,238847,175059,114245,60656,42887,39312,4834,675840,1440403
RAJASTHAN,Banswara,829343,513854,315489,240067,190259,137780,75011,50438,47094,8145,748794,1789708
RAJASTHAN,Chittaurgarh,821825,514851,306974,245603,225700,170455,90889,58129,67155,10768,868699,1584244
RAJASTHAN,Kota,1298345,765396,532949,286676,294591,250092,172538,118710,167778,27485,1317870,1906012
RAJASTHAN,Baran,693307,432607,260700,203489,194024,144190,76209,46847,49939,8057,722755,1268597
RAJASTHAN,Jhalawar,739792,466815,272977,226614,203488,143108,73388,46267,47985,6972,747822,1444502
RAJASTHAN,Udaipur,1582629,973444,609185,442946,386075,277392,164290,102085,142672,20010,1535470,3064141
RAJASTHAN,Pratapgarh,401515,250122,151393,142397,111276,70969,35206,21854,19109,2137,402948,891569
UTTAR PRADESH,Saharanpur,2077108,1220114,856994,474060,600668,431491,256510,163463,154153,10083,2090428,3369945
UTTAR PRADESH,Muzaffarnagar,2417339,1448528,968811,826387,780470,531913,281747,148770,98691,5608,2673586,4105123
UTTAR PRADESH,Bijnor,2135393,1241471,893922,498971,827447,549594,255028,159528,148185,14658,2453411,3762094
UTTAR PRADESH,Moradabad,2263848,1357435,906413,635957,725118,492338,296210,186311,186489,23372,2545795,4643087
UTTAR PRADESH,Rampur,1043666,630408,413258,278477,374898,171242,85117,51703,43839,3169,1008445,2243858
UTTAR PRADESH,Jyotiba Phule Nagar,983110,600541,382569,251669,352835,230640,161282,164763,69522,3021,1233732,1753947
UTTAR PRADESH,Meerut,2141488,1254520,886968,412280,495861,469403,359944,254337,275076,36096,2302997,3293309
UTTAR PRADESH,Baghpat,797970,489858,308112,139646,272939,215070,132197,79475,44164,3730,887221,1263921
UTTAR PRADESH,Ghaziabad,3123264,1811397,1311867,534606,858286,797473,597661,475439,255949,26399,3545813,4430883
UTTAR PRADESH,Gautam Buddha Nagar,1122947,666065,456882,201277,330623,283031,218587,194796,101645,5058,1335017,1677301
UTTAR PRADESH,Bulandshahr,2031656,1253314,778342,443641,540754,475146,338138,217882,151182,17796,2184539,3369857
UTTAR PRADESH,Aligarh,2092567,1283380,809187,456870,491605,443958,334738,216997,172585,20498,2137251,3489432
UTTAR PRADESH,Mahamaya Nagar,942572,579157,363415,181444,297282,269717,166861,89435,49812,5386,1059937,1490751
UTTAR PRADESH,Mathura,1507746,943346,564400,303291,420976,344961,233264,155937,103102,10262,1571793,2263152
UTTAR PRADESH,Agra,2680510,1614594,1065916,600839,904836,647340,450571,317618,199395,20781,3141380,4104582
UTTAR PRADESH,Firozabad,1521806,912314,609492,324525,416295,368905,277163,166249,108627,11313,1673077,2345192
UTTAR PRADESH,Mainpuri,1203885,712110,491775,234774,353287,319158,230731,144516,111696,12281,1406443,1925936
UTTAR PRADESH,Budaun,1547477,986501,560976,556130,585283,295943,154425,86760,64222,7291,1750054,3696399
UTTAR PRADESH,Bareilly,2191759,1342697,849062,717585,641251,442110,272840,172554,146446,16806,2409592,4154119
UTTAR PRADESH,Pilibhit,1061095,654290,406805,294135,281158,240057,117838,77602,66129,9713,1086632,2064471
UTTAR PRADESH,Shahjahanpur,1490930,915142,575788,451571,476064,315873,158430,96308,87355,8885,1594486,2919101
UTTAR PRADESH,Kheri,2034044,1237157,796887,717340,621684,442748,223669,129627,128548,10846,2274462,4108040
UTTAR PRADESH,Sitapur,2283733,1397702,886031,714304,656401,482220,221898,136383,127750,8775,2347731,4489427
UTTAR PRADESH,Hardoi,2221601,1374587,847014,741817,906861,510507,247265,138583,103523,9048,2657604,4139208
UTTAR PRADESH,Unnao,1773584,1053063,720521,501457,512965,415378,240024,136688,101934,7173,1915619,3045722
UTTAR PRADESH,Lucknow,3127260,1742440,1384820,489898,554301,552171,428121,378742,639260,52132,3094625,4241505
UTTAR PRADESH,Rae Bareli,1965843,1165965,799878,540661,538301,477689,270775,182823,153041,15662,2178952,3465678
UTTAR PRADESH,Farrukhabad,1092677,654827,437850,270550,330084,257279,184298,115069,110391,9368,1277039,1987999
UTTAR PRADESH,Kannauj,1017087,603596,413491,237853,283674,263749,175582,107628,95072,7194,1170752,1713786
UTTAR PRADESH,Etawah,1062003,623583,438420,171216,292852,298700,195192,121283,118571,13400,1211214,1608922
UTTAR PRADESH,Auraiya,930836,546198,384638,133123,291837,282449,168866,101542,79012,6531,1063360,1339584
UTTAR PRADESH,Kanpur Dehat,1170243,692964,477279,235341,344866,341845,223529,157167,97740,5930,1406418,1881584
UTTAR PRADESH,Kanpur Nagar,3243022,1829179,1413843,338620,766906,794860,651228,515772,396565,26827,3490778,4167084
UTTAR PRADESH,Jalaun,1075196,653430,421766,169207,327534,282919,167911,104699,106888,10399,1169557,1631223
UTTAR PRADESH,Jhansi,1304513,783705,520808,184997,370685,341371,186348,99814,92586,11783,1287584,1770672
UTTAR PRADESH,Lalitpur,641191,397586,243605,185575,202692,154118,61543,32237,34658,3535,674358,1183894
UTTAR PRADESH,Hamirpur,653299,408125,245174,159593,238344,211029,103334,59914,59612,4094,835920,1200768
UTTAR PRADESH,Mahoba,488106,302283,185823,119002,141201,131165,60400,33810,37165,3926,526669,930318
UTTAR PRADESH,Banda,1002937,630626,372311,325773,415195,249238,114783,61702,63112,5728,1235531,1823556
UTTAR PRADESH,Chitrakoot,531072,330339,200733,168472,174106,124256,69641,40266,35826,3660,616227,1000135
UTTAR PRADESH,Fatehpur,1512166,911003,601163,409875,463642,376472,227119,134445,116445,10212,1738210,2633388
UTTAR PRADESH,Pratapgarh,1931559,1121381,810178,427626,558350,456752,332742,238011,197846,20047,2231374,3291010
UTTAR PRADESH,Kaushambi,813424,507279,306145,184229,253910,180825,146757,89011,45341,5115,905188,1575938
UTTAR PRADESH,Allahabad,3665727,2199340,1466387,823863,934881,738076,596615,502826,428871,36764,4061896,5817994
UTTAR PRADESH,Bara Banki,1692458,1010518,681940,533140,420824,350564,197780,132332,113799,12281,1760720,3301561
UTTAR PRADESH,Faizabad,1450901,838339,612562,356093,361114,347114,231129,176303,179996,18947,1670696,2652611
UTTAR PRADESH,Ambedkar Nagar,1486939,846676,640263,342667,392873,353570,247028,172872,194387,15458,1718855,2532357
UTTAR PRADESH,Sultanpur,2239902,1300248,939654,460210,637015,526973,306046,188848,176414,15277,2310783,3429674
UTTAR PRADESH,Bahraich,1398368,878285,520083,447648,493760,215939,104762,65106,47690,7028,1381933,3302899
UTTAR PRADESH,Shrawasti,423313,276700,146613,155698,97160,56242,29567,19744,15648,1535,375594,1077144
UTTAR PRADESH,Balrampur,868357,544943,323414,379253,227932,122911,65516,40633,37109,2777,876131,2208948
UTTAR PRADESH,Gonda,1679994,1034181,645813,678171,425584,305644,192664,144067,118176,8722,1873028,3493810
UTTAR PRADESH,Siddharthnagar,1228926,740718,488208,676987,335977,204260,110056,73465,56516,10526,1467787,2684814
UTTAR PRADESH,Basti,1393783,819719,574064,470355,349221,324085,211477,162961,143642,13030,1674771,2695963
UTTAR PRADESH,Sant Kabir Nagar,954949,567098,387851,341757,290532,205875,129442,86528,63506,8882,1126522,1809575
UTTAR PRADESH,Mahrajganj,1419144,881674,537470,456350,388464,308064,185236,129222,95863,11219,1574418,2827013
UTTAR PRADESH,Gorakhpur,2700328,1593890,1106438,873031,618398,560246,425913,316166,273903,36253,3103910,4557870
UTTAR PRADESH,Kushinagar,1954820,1183722,771098,836856,424892,367405,249265,170911,119625,11970,2180924,3731239
UTTAR PRADESH,Deoria,1875239,1079288,795951,602403,473097,449571,372031,277548,194341,23334,2392325,3522433
UTTAR PRADESH,Azamgarh,2771917,1559414,1212503,831966,1344726,879745,489060,312571,158303,8087,4024458,5242604
UTTAR PRADESH,Mau,1363044,773082,589962,344570,410737,320743,256784,209493,150462,15771,1708560,2367797
UTTAR PRADESH,Ballia,1963590,1160960,802630,436021,515010,443440,409484,323582,200434,20283,2348254,3380787
UTTAR PRADESH,Jaunpur,2731677,1565394,1166283,665376,939616,769693,520111,353996,256398,25909,3531099,4875888
UTTAR PRADESH,Ghazipur,2197549,1293553,903996,566504,691057,563310,449909,334003,186306,12795,2803884,3812880
UTTAR PRADESH,Chandauli,1174606,699454,475152,295979,367768,276638,196240,135962,88299,7586,1368472,1911719
UTTAR PRADESH,Varanasi,2403903,1389116,1014787,467782,608174,557052,447926,351391,281652,34841,2748818,3655185
UTTAR PRADESH,Sant Ravidas Nagar (Bhadohi),910146,546782,363364,257527,291926,232072,167524,120944,86533,10304,1166830,1719788
UTTAR PRADESH,Mirzapur,1428683,865837,562846,361642,421577,340261,232189,177109,140668,17680,1691126,2559668
UTTAR PRADESH,Sonbhadra,985708,601988,383720,306218,297226,212565,120822,82614,63846,9357,1092648,1837774
UTTAR PRADESH,Etah,1055202,647042,408160,238019,214091,201984,178434,119665,88607,8092,1048892,1767202
UTTAR PRADESH,Kanshiram Nagar,724850,452803,272047,256688,193410,150247,108558,61662,48079,4981,823625,1471791
BIHAR,Pashchim Champaran,1759481,1091226,668255,1053481,543965,250243,159563,98732,70669,6035,2182688,3893566
BIHAR,Purba Champaran,2276957,1407603,869354,1280809,982506,450631,241118,121594,68781,5149,3150588,5293345
BIHAR,Sheohar,283698,171645,112053,128209,91277,37063,25657,16031,10091,661,308989,657067
BIHAR,Sitamarhi,1436794,885188,551606,733380,394422,196321,136500,92783,70549,11936,1635891,3488656
BIHAR,Madhubani,2155338,1340085,815253,783888,771417,520875,303114,170563,137780,11352,2698989,4702068
BIHAR,Supaul,1033283,647672,385611,467768,269737,157787,99530,69665,45726,5850,1116063,2336331
BIHAR,Araria,1195768,727643,468125,625357,426625,206161,112955,68177,39627,6938,1485840,3139606
BIHAR,Kishanganj,745056,439921,305135,356401,235779,89025,42778,25989,15386,3761,769119,1714516
BIHAR,Purnia,1332326,805261,527065,668690,360243,184327,119259,83226,59996,11116,1486857,3285643
BIHAR,Katihar,1280190,762256,517934,472616,444260,237243,133811,88498,57114,11896,1445438,3150989
BIHAR,Madhepura,834577,517666,316911,340813,189431,114474,99437,79891,44955,6509,875510,2077788
BIHAR,Saharsa,804996,506374,298622,348300,194897,104182,90182,64560,47051,6016,855188,2006537
BIHAR,Darbhanga,1816634,1125566,691068,672797,490534,332382,224622,152540,129597,26073,2028545,4231743
BIHAR,Muzaffarpur,2509232,1487117,1022115,1092952,743623,419433,299475,194920,138916,14475,2903794,4828232
BIHAR,Gopalganj,1382998,793905,589093,540603,470828,291624,223776,123249,79109,7690,1736879,2714598
BIHAR,Siwan,1930175,1115906,814269,689880,612635,445257,355277,186817,119164,12091,2421121,3628240
BIHAR,Saran,2157454,1285767,871687,793945,693465,433759,361171,213251,148065,9848,2653504,3967204
BIHAR,Vaishali,1926740,1152576,774164,810191,487594,370247,291392,178320,124448,9094,2271286,3750438
BIHAR,Samastipur,2142880,1293575,849305,781038,710468,438908,284082,186153,129933,19126,2549708,4546359
BIHAR,Begusarai,1548673,918507,630166,577601,484502,291877,207136,144783,101836,14599,1822334,3064885
BIHAR,Khagaria,768028,461153,306875,350601,233494,130004,100555,65931,38697,5969,925251,1828574
BIHAR,Bhagalpur,1573066,937669,635397,614644,524322,300767,247079,154643,118843,16119,1976417,3116132
BIHAR,Banka,965321,590961,374360,408188,386707,196305,120653,63103,35767,3922,1214645,2094476
BIHAR,Munger,801817,473741,328076,226699,158699,146414,147152,101907,64469,4394,849734,1348410
BIHAR,Lakhisarai,507270,305182,202088,172076,149312,111684,85807,48001,27261,3814,597955,1048922
BIHAR,Sheikhpura,328676,196431,132245,129673,110525,59529,52860,33856,19676,3399,409518,715127
BIHAR,Nalanda,1519933,919558,600375,581978,486266,320839,274556,177358,133032,11159,1985188,3309573
BIHAR,Patna,3459679,2028047,1431632,1244842,1095655,920051,698351,463361,452340,46126,4920726,7511199
BIHAR,Bhojpur,1599151,973486,625665,581580,605307,367059,313509,163303,131137,10630,2172525,3177665
BIHAR,Buxar,989807,593544,396263,331675,420187,256124,178044,89306,64117,5224,1344677,1802491
BIHAR,Kaimur (Bhabua),920276,549923,370353,318859,294927,210899,147315,86815,70169,9576,1138560,1689877
BIHAR,Rohtas,1799832,1061783,738049,535187,548971,399053,333053,194928,161555,16006,2188753,3065196
BIHAR,Aurangabad,1466002,868733,597269,559512,482199,302662,253142,136783,91371,8329,1833998,2618129
BIHAR,Gaya,2297613,1368803,928810,902272,757690,447480,342254,191824,131163,12047,2784730,4738098
BIHAR,Nawada,1091012,659474,431538,601011,368649,195072,161127,95943,64585,3130,1489517,2580956
BIHAR,Jamui,858588,534385,324203,420472,317612,153973,104211,56137,29633,3439,1085477,1850774
BIHAR,Jehanabad,618881,374412,244469,211761,165906,117558,112966,68748,45519,3539,725997,1221874
BIHAR,Arwal,386351,235279,151072,123288,118311,80704,81975,48822,27945,1435,482480,772575
SIKKIM,North  District,30450,18579,11871,6030,8276,6181,3223,1993,1406,273,27382,35055
SIKKIM,West District,93432,51988,41444,30518,30827,19973,10005,6439,4831,527,103120,131347
SIKKIM,South District,106741,59357,47384,24507,32427,22340,12415,7260,5766,488,105203,129598
SIKKIM,East District,214329,121345,92984,33578,53789,45602,29215,19258,20904,2682,205028,243170
ARUNACHAL PRADESH,Tawang,26073,17720,8353,4904,4730,4029,2140,1989,1379,667,19838,39041
ARUNACHAL PRADESH,West Kameng,48492,29566,18926,8836,10317,8428,5633,3987,2693,299,40193,65799
ARUNACHAL PRADESH,East Kameng,38449,21599,16850,11713,10487,8852,6213,4510,2330,142,44247,76010
ARUNACHAL PRADESH,Papum Pare,121048,65794,55254,15368,21956,21376,20007,17342,13840,926,110815,141175
ARUNACHAL PRADESH,Upper Subansiri,45278,24807,20471,10219,16118,15339,10348,8017,4276,473,64790,93154
ARUNACHAL PRADESH,West Siang,64746,36777,27969,14227,17675,15908,11441,8418,6030,521,74220,102176
ARUNACHAL PRADESH,East Siang,62576,34210,28366,9938,13713,13968,10937,9498,6540,525,65119,86662
ARUNACHAL PRADESH,Upper Siang,18195,10723,7472,3952,5584,4915,2935,2211,1349,46,20992,32201
ARUNACHAL PRADESH,Changlang,73174,44027,29147,20425,22537,17354,10032,5641,3633,834,80456,137746
ARUNACHAL PRADESH,Tirap,47974,29313,18661,13585,16989,12077,7834,4305,2134,182,57106,107734
ARUNACHAL PRADESH,Lower Subansiri,54057,29470,24587,8492,10821,11661,9861,7674,5230,295,54034,71307
ARUNACHAL PRADESH,Kurung Kumey,36606,20258,16348,12661,15054,12264,6997,4353,2031,299,53659,96280
ARUNACHAL PRADESH,Dibang Valley,4436,2614,1822,696,1258,1060,809,656,356,91,4926,7111
ARUNACHAL PRADESH,Lower Dibang Valley,31849,18087,13762,5875,7957,7351,5508,3570,2795,85,33141,47547
ARUNACHAL PRADESH,Lohit,83062,48380,34682,19306,25179,20643,13070,7612,5180,584,91574,143995
ARUNACHAL PRADESH,Anjaw,9990,6523,3467,2879,2946,2170,1167,793,502,98,10555,19278
NAGALAND,Mon,119626,67432,52194,37431,46055,30500,7628,3565,1772,107,127058,257587
NAGALAND,Mokokchung,159494,83479,76015,20259,43483,54035,27425,13077,10299,870,169448,192003
NAGALAND,Zunheboto,102881,53504,49377,16523,30889,35113,17282,8821,5560,1107,115295,141283
NAGALAND,Wokha,128208,67385,60823,15865,37024,41627,18746,10223,8030,401,131916,156964
NAGALAND,Dimapur,278037,150142,127895,34539,61815,80076,44343,26712,27532,2939,277956,336882
NAGALAND,Phek,105893,57926,47967,22494,32722,30434,12785,7268,5926,481,112110,156566
NAGALAND,Tuensang,117511,63653,53858,29602,40900,33514,15013,6008,2760,116,127913,194363
NAGALAND,Longleng,29859,16139,13720,7986,11884,8672,3458,1695,595,15,34305,52535
NAGALAND,Kiphire,41232,22675,18557,11197,15740,13645,5204,2052,997,76,48911,81031
NAGALAND,Kohima,197489,107038,90451,21654,46756,57726,30518,19855,23439,1770,201718,247520
NAGALAND,Peren,62204,34584,27620,9248,24527,20732,8082,3938,2169,75,68771,93561
MANIPUR,Senapati,264477,148012,116465,46757,81735,91395,62033,40438,24940,598,347896,538897
MANIPUR,Tamenglong,85006,47403,37603,11155,28461,26794,17867,11645,7102,270,103294,148611
MANIPUR,Churachandpur,195935,104013,91922,32860,67907,65475,38567,23284,14523,509,243125,300686
MANIPUR,Bishnupur,156333,87313,69020,15941,36011,50004,31775,20077,20074,1440,175322,242932
MANIPUR,Thoubal,269304,152617,116687,32396,69738,87932,55803,37899,28550,3214,315532,433620
MANIPUR,Imphal West,392626,205985,186641,32811,66042,104229,77472,60821,81876,9564,432815,520063
MANIPUR,Imphal East,324664,173314,151350,38436,69144,99202,60422,47390,50647,4102,369343,459593
MANIPUR,Ukhrul,129829,70148,59681,20670,29382,38350,31734,22729,15636,405,158906,201062
MANIPUR,Chandel,90302,51053,39249,17382,28163,30589,18971,12213,8105,240,115663,153854
MIZORAM,Mamit,60191,32977,27214,9328,19711,19949,10756,3180,1771,22,64717,84808
MIZORAM,Kolasib,65895,34147,31748,11367,18046,20399,9849,3473,2530,62,65726,79943
MIZORAM,Aizawl,340595,169547,171048,29332,68214,100103,78752,37701,31310,2058,347470,385718
MIZORAM,Champhai,100802,51440,49362,14491,31359,30454,16259,4956,4087,78,101684,117133
MIZORAM,Serchhip,54476,27598,26878,8771,14985,16237,9062,2915,2128,35,54133,60096
MIZORAM,Lunglei,121122,64515,56607,22181,33313,34774,19918,8503,5509,116,124314,156765
MIZORAM,Lawngtlai,62861,36444,26417,19890,21114,16629,10538,3763,2515,125,74574,129448
MIZORAM,Saiha,42233,21861,20372,8422,14151,12130,7269,3628,2204,69,47873,56660
TRIPURA,West Tripura,1361354,722998,638356,248343,421485,451563,156277,88122,85405,13478,1464673,1743726
TRIPURA,South Tripura,646810,351082,295728,129846,223185,204201,70173,31690,26870,5160,691125,879488
TRIPURA,Dhalai,276217,151643,124574,64515,84516,74015,21430,9157,6425,890,260948,370078
TRIPURA,North Tripura,520402,275646,244756,129329,179547,158211,47160,22720,18419,3736,559122,715962
MEGHALAYA,West Garo Hills,358702,193438,165264,85733,129178,90963,70941,29404,10856,3547,420622,629522
MEGHALAYA,East Garo Hills,192147,102513,89634,51578,70679,52762,31328,9473,2484,298,218602,319383
MEGHALAYA,South Garo Hills,82062,45003,37059,25906,28921,21506,13858,3998,826,831,95846,140695
MEGHALAYA,West Khasi Hills,230678,117307,113371,80318,78208,45046,28417,12295,6450,541,251275,384519
MEGHALAYA,Ribhoi,155859,80977,74882,57680,58581,31103,20134,7632,3911,633,179674,258648
MEGHALAYA,East Khasi Hills,578030,287270,290760,118135,163729,127722,94579,58836,61639,9397,634037,802612
MEGHALAYA,Jaintia Hills,187527,87371,100156,67749,61526,34677,26748,13544,8039,2934,215217,380401
ASSAM,Kokrajhar,489305,275220,214085,116899,166013,154715,78788,39571,17287,2733,576006,916607
ASSAM,Dhubri,922341,511551,410790,253638,299724,250242,100387,65082,34401,3863,1007337,1999405
ASSAM,Goalpara,563577,304302,259275,124700,213510,183904,73683,39885,18294,3464,657440,1032511
ASSAM,Barpeta,897058,499038,398020,210607,307884,300845,121924,87377,46947,8007,1083591,1747752
ASSAM,Morigaon,539902,289698,250204,130091,195656,179810,67969,40803,18462,2791,635582,987338
ASSAM,Nagaon,1710716,921850,788866,392616,638088,576214,199792,115864,66994,10351,1999919,2873116
ASSAM,Sonitpur,1108572,620525,488047,216097,416218,377653,141373,90385,49901,6412,1298039,1925180
ASSAM,Lakhimpur,683486,375552,307934,126950,212080,217497,107326,82885,44212,4731,795681,1071358
ASSAM,Dhemaji,423028,237761,185267,79107,138838,136371,80804,55399,28006,2868,521393,716377
ASSAM,Tinsukia,798322,453449,344873,150893,266717,276292,109805,61040,38152,7353,910252,1327333
ASSAM,Dibrugarh,884531,491361,393170,143189,243607,301287,139813,89500,59380,6984,983760,1324504
ASSAM,Sivasagar,813505,444767,368738,115378,208891,280517,158118,96939,53437,5554,918834,1165948
ASSAM,Jorhat,794929,432335,362594,99454,201680,295444,128050,97025,62608,8433,892694,1101864
ASSAM,Golaghat,721764,396475,325289,117393,223902,261192,111145,66197,36887,4084,820800,1079697
ASSAM,Karbi Anglong,557214,314253,242961,109324,212224,199289,93137,40602,18225,3426,676227,986320
ASSAM,Dima Hasao,140873,78559,62314,20780,43811,53736,27839,10859,5565,598,163188,220819
ASSAM,Cachar,1174128,639946,534182,256855,447993,379469,156156,79766,45341,12951,1378531,1736438
ASSAM,Karimganj,795297,435942,359355,198059,333885,257931,76685,39637,21408,7903,935508,1239293
ASSAM,Hailakandi,407366,226836,180530,88596,177984,139029,50056,28504,11608,4265,500042,673348
ASSAM,Bongaigaon,434078,237114,196964,93591,138294,133643,55924,35491,20221,2267,479431,740152
ASSAM,Chirang,259902,145869,114033,64999,92943,84682,37792,17702,6594,918,305630,478569
ASSAM,Kamrup,995319,550219,445100,163849,290097,353861,154831,118849,55011,6444,1142942,1535620
ASSAM,Kamrup Metropolitan,1001191,537227,463964,79177,160490,255522,148429,143478,167972,30795,985863,1114636
ASSAM,Nalbari,531771,293184,238587,75866,141690,192771,81507,71734,39368,3693,606629,795589
ASSAM,Baksa,572837,322614,250223,95444,195643,225635,96782,53446,15422,1839,684211,978995
ASSAM,Darrang,487039,268666,218373,119027,163277,161153,59039,47398,22267,3079,575240,950796
ASSAM,Udalguri,469926,264326,205600,101146,155720,162369,63394,34334,14001,1612,532576,839409
WEST BENGAL,Darjiling,1315585,717673,597912,183479,344865,402415,176129,113905,110193,12851,1343837,1759190
WEST BENGAL,Jalpaiguri,2498780,1396622,1102158,455854,765613,814395,292056,150360,129393,18916,2626587,3830010
WEST BENGAL,Koch Bihar,1850504,1028733,821771,393492,595555,590626,209153,93119,81100,8712,1971757,2844892
WEST BENGAL,Uttar Dinajpur,1489667,853495,636172,402590,488047,422777,163106,73395,59457,12723,1622095,3053359
WEST BENGAL,Dakshin Dinajpur,1083685,596474,487211,247675,323965,327064,135556,63286,52345,5190,1155081,1689475
WEST BENGAL,Maldah,2086432,1152019,934413,478902,629137,595551,238078,109719,92207,18330,2161924,4121958
WEST BENGAL,Murshidabad,4055834,2177187,1878647,837828,1428661,1210859,443254,230242,170051,25975,4346870,7378711
WEST BENGAL,Birbhum,2158447,1201481,956966,417769,661190,622372,245201,122865,115743,15205,2200345,3547147
WEST BENGAL,Barddhaman,5247208,2918040,2329168,800473,1437198,1605634,698251,405935,439823,62616,5449930,7646816
WEST BENGAL,Nadia,3480555,1878866,1601689,605490,1093403,1052487,412193,236828,209562,25491,3635454,5205581
WEST BENGAL,North Twenty Four Parganas,7608693,4056046,3552647,1090829,1874051,2094743,989053,670977,852923,127926,7700502,9602136
WEST BENGAL,Hugli,4078388,2211777,1866611,676265,1172797,1174912,515807,333658,380060,44252,4297751,5478557
WEST BENGAL,Bankura,2232992,1299337,933655,450029,545200,686924,261478,143882,133465,20379,2241357,3659144
WEST BENGAL,Puruliya,1624905,1002058,622847,299355,480046,528068,177459,91807,77621,10072,1664428,2937227
WEST BENGAL,Haora,3605206,1942824,1662382,516323,1059842,1084155,446743,284481,304594,37027,3733165,4659826
WEST BENGAL,Kolkata,3588137,1926915,1661222,255171,597841,820902,555529,425245,691804,89701,3436193,3847181
WEST BENGAL,South Twenty Four Parganas,5531657,3043277,2488380,1119126,1775793,1657528,564417,316571,322157,46568,5802160,7986668
WEST BENGAL,Paschim Medinipur,4078412,2266913,1811499,831300,1139784,1289873,477973,262072,211437,35396,4247835,5937819
WEST BENGAL,Purba Medinipur,3923194,2149073,1774121,776367,1219166,1289927,444668,236549,184225,30677,4181579,5203120
JHARKHAND,Garhwa,653476,405161,248315,207665,195565,147446,87844,46882,28144,2830,716376,1274228
JHARKHAND,Chatra,510061,303902,206159,200861,161729,102033,63670,35342,21697,2046,587378,1055353
JHARKHAND,Kodarma,390249,238780,151469,129677,130315,80561,52622,26415,20907,2374,442871,740863
JHARKHAND,Giridih,1253475,783736,469739,503261,443980,261309,146464,77540,55122,8449,1496125,2543810
JHARKHAND,Deoghar,793538,489837,303701,217460,266292,190171,96331,54419,43979,6699,875351,1510895
JHARKHAND,Godda,604519,376212,228307,217607,190777,126766,79430,47395,30870,4002,696847,1350311
JHARKHAND,Sahibganj,483263,287303,195960,146399,171416,110822,52248,28087,19832,2593,531397,1168693
JHARKHAND,Pakur,352881,206989,145892,100367,133770,79045,29934,15700,9822,1525,370163,918597
JHARKHAND,Dhanbad,1722204,1014950,707254,317918,501453,449506,305054,186697,107382,14615,1882625,2545147
JHARKHAND,Bokaro,1273520,759088,514432,242467,338861,342646,232434,154076,116396,21157,1448037,2043961
JHARKHAND,Lohardaga,259707,149568,110139,82873,84920,63545,38503,21987,13847,976,306651,494974
JHARKHAND,Purbi Singhbhum,1507699,856526,651173,202047,346644,369670,278853,162210,157688,25048,1542160,2068076
JHARKHAND,Palamu,1024563,621706,402857,303053,296937,231565,160964,100290,63595,7117,1163521,1966945
JHARKHAND,Latehar,350682,209706,140976,109491,121529,88787,46142,23885,13956,1017,404807,754084
JHARKHAND,Hazaribagh,1013249,596113,417136,253962,322344,255576,173378,99945,79898,6512,1191615,1805389
JHARKHAND,Ramgarh,596497,350031,246466,115199,138748,134324,101381,70249,47207,5397,612505,904567
JHARKHAND,Dumka,672409,406275,266134,229157,229259,149009,69525,38383,25593,2697,743623,1344701
JHARKHAND,Jamtara,426312,258260,168052,131150,132014,85745,40613,22995,14802,1578,428897,794909
JHARKHAND,Ranchi,1911433,1085244,826189,361522,547583,495515,370847,247237,195181,28424,2246309,2860164
JHARKHAND,Khunti,284575,164741,119834,64029,89730,89924,48591,20689,10130,537,323630,501486
JHARKHAND,Gumla,559720,321795,237925,136719,242580,182260,82114,45613,23742,2913,715941,1038060
JHARKHAND,Simdega,343483,191991,151492,82317,130068,97580,47836,24842,13674,1197,397514,588855
JHARKHAND,Pashchimi Singhbhum,727561,439273,288288,290007,461276,202752,79516,35824,10743,574,1080692,1359708
JHARKHAND,Saraikela-Kharsawan,612993,365332,247661,134506,259984,177763,106348,49944,29840,1443,759828,988771
ORISSA,Bargarh,983783,557217,426566,205253,310784,247014,147217,58840,49238,8133,1026479,1469212
ORISSA,Jharsuguda,405879,228092,177787,69122,101541,103622,70928,32909,22010,7932,408064,551572
ORISSA,Sambalpur,703691,393192,310499,133005,185289,171876,108455,50705,45828,13071,708229,990477
ORISSA,Debagarh,197819,112649,85170,47615,58231,54088,27415,13420,9041,1729,211539,320350
ORISSA,Sundargarh,1342322,750147,592175,208100,350349,335380,243386,120373,94710,36590,1388888,2049353
ORISSA,Kendujhar,1052518,605119,447399,214518,287402,289350,158035,70059,57762,13918,1091044,1791705
ORISSA,Mayurbhanj,1369397,794171,575226,283489,390037,385216,214921,92060,72847,17415,1455985,2550829
ORISSA,Baleshwar,1621232,902359,718873,342192,470502,416510,267354,112392,105962,27493,1742405,2371032
ORISSA,Bhadrak,1094140,596269,497871,210736,391081,297270,177013,71815,67536,17449,1232900,1556045
ORISSA,Kendrapara,1089265,579970,509295,218444,357621,298557,203472,76449,75926,12507,1242976,1537699
ORISSA,Jagatsinghapur,889027,481049,407978,151737,251767,251332,185671,72703,70602,14001,997813,1207797
ORISSA,Cuttack,2011469,1103033,908436,289414,545514,513039,328319,159456,181601,45279,2062622,2534804
ORISSA,Jajapur,1290455,706396,584059,261077,433653,330016,223657,96963,87623,19271,1452260,1913213
ORISSA,Dhenkanal,829910,464093,365817,188872,238599,193395,132002,53162,43064,10903,859997,1201884
ORISSA,Anugul,869456,494425,375031,180523,265782,204235,129226,58029,45588,16602,899985,1247836
ORISSA,Nayagarh,688362,392333,296029,174904,227102,177180,90089,36951,33148,5685,745059,977617
ORISSA,Khordha,1749936,957515,792421,276378,445785,436534,295099,177974,247498,66645,1945913,2317157
ORISSA,Puri,1291939,704857,587082,251520,413605,364098,179086,84374,87000,15511,1395194,1704984
ORISSA,Ganjam,2210050,1262652,947398,518072,767140,508511,297490,121151,97147,31266,2340777,3396108
ORISSA,Gajapati,262537,153663,108874,68405,76419,54787,36977,17084,12556,1882,268110,603931
ORISSA,Kandhamal,399786,233900,165886,108606,145604,108773,48856,21351,14962,2462,450614,738562
ORISSA,Baudh,271612,158648,112964,74205,98316,67549,30799,12500,8124,1683,293176,439568
ORISSA,Subarnapur,398421,230393,168028,86120,139994,105846,65368,25556,16745,4881,444510,611754
ORISSA,Balangir,927260,545672,381588,240180,298288,226728,116297,54694,42401,6810,985398,1706787
ORISSA,Nuapada,299383,180903,118480,64389,114394,73787,51886,19577,10131,4316,338480,654566
ORISSA,Kalahandi,802036,484177,317859,213426,225468,172905,94044,40383,27385,6840,780451,1545819
ORISSA,Rayagada,407735,241959,165776,84956,97387,73210,46001,21439,17681,6306,346980,930120
ORISSA,Nabarangapur,470379,286984,183395,116468,155611,95988,44522,16463,11198,2282,442532,1181722
ORISSA,Koraput,568090,340843,227247,158847,158653,98266,60589,32257,29000,10200,547812,1318519
ORISSA,Malkangiri,244706,147001,97705,60913,64683,44962,19031,8487,5585,1202,204863,595219
CHHATTISGARH,Koriya,397823,229923,167900,143413,109639,87969,47127,38677,26802,4134,457761,637400
CHHATTISGARH,Surguja,1187941,694686,493255,364452,338509,281260,135374,105992,64607,9524,1299718,2291584
CHHATTISGARH,Jashpur,495415,280656,214759,120768,137681,127299,64188,50562,26161,3166,529825,858263
CHHATTISGARH,Raigarh,951639,542756,408883,246480,260661,210964,130700,93340,66358,8804,1017307,1477473
CHHATTISGARH,Korba,748759,433391,315368,178191,188303,168387,89167,83166,61215,11792,780221,1190407
CHHATTISGARH,Janjgir - Champa,1019634,593679,425955,257020,241692,241761,152183,127543,58712,7630,1086541,1674275
CHHATTISGARH,Bilaspur,1596560,932474,664086,382091,407692,337793,189296,152838,134637,19654,1624001,2567113
CHHATTISGARH,Kabeerdham,414167,248503,165664,126806,123840,84147,37650,28074,16671,1679,418867,795719
CHHATTISGARH,Rajnandgaon,1008379,561355,447024,263447,287436,267653,105149,82141,51698,5340,1062864,1530418
CHHATTISGARH,Durg,2303378,1284612,1018766,463598,573291,497668,309508,286244,202424,30555,2363288,3186789
CHHATTISGARH,Raipur,2629749,1493158,1136591,618508,664470,552373,313247,267265,227382,31483,2674728,3922162
CHHATTISGARH,Mahasamund,637963,364089,273874,179770,194739,152183,78583,57949,33357,5951,702532,1087296
CHHATTISGARH,Dhamtari,546833,303924,242909,143128,148544,120146,65196,58875,31319,5096,572304,786941
CHHATTISGARH,Uttar Bastar Kanker,456042,258298,197744,135206,124893,100674,47002,43956,21410,1658,474799,717838
CHHATTISGARH,Bastar,650863,382335,268528,183667,178766,139330,60936,57413,32895,3227,656234,1385784
CHHATTISGARH,Narayanpur,56621,33449,23172,16980,16034,9513,4158,4488,2216,268,53657,131988
CHHATTISGARH,Dakshin Bastar Dantewada,191237,116529,74708,40079,39023,27720,16665,16905,11197,1372,152961,489924
CHHATTISGARH,Bijapur,86919,54076,32843,25597,22787,14170,7192,6755,3421,147,80069,243347
MADHYA PRADESH,Sheopur,328025,208201,119824,90911,70840,43009,37072,24732,17091,1497,285152,678293
MADHYA PRADESH,Morena,1179685,747652,432033,288979,285682,228234,170254,115790,71005,8265,1168209,1875126
MADHYA PRADESH,Bhind,1094917,676513,418404,202629,261162,199044,140743,96011,50222,8059,957870,1346343
MADHYA PRADESH,Gwalior,1357210,803114,554096,235648,235924,204871,193082,166719,193947,23148,1253339,1807825
MADHYA PRADESH,Datia,491445,303815,187630,132176,131372,88949,73398,48978,34853,4262,513988,774064
MADHYA PRADESH,Shivpuri,900846,573242,327604,261087,214162,125117,84684,58509,44812,6218,794589,1514136
MADHYA PRADESH,Tikamgarh,747940,459353,288587,202448,188694,143231,78053,58245,35034,5340,711045,1370393
MADHYA PRADESH,Chhatarpur,943033,572010,371023,270951,236054,160310,112961,77787,59704,7837,925604,1695872
MADHYA PRADESH,Panna,552559,332140,220419,171707,134936,99251,70359,47903,29795,3052,557003,985000
MADHYA PRADESH,Sagar,1545719,908607,637112,347752,426916,297079,214137,137899,116753,14346,1554882,2266686
MADHYA PRADESH,Damoh,747715,445737,301978,197917,217296,150040,95032,64414,41158,5260,771117,1240155
MADHYA PRADESH,Satna,1371781,801051,570730,338947,334635,309536,197373,148091,105499,16052,1450133,2165642
MADHYA PRADESH,Rewa,1441757,845572,596185,344362,330131,312931,206274,180635,122371,11438,1508142,2274308
MADHYA PRADESH,Umaria,356672,210907,145765,90791,94011,74854,43418,27216,18144,2784,351218,582000
MADHYA PRADESH,Neemuch,508834,307889,200945,137656,127167,83189,69134,53465,42343,6119,519073,808186
MADHYA PRADESH,Mandsaur,834591,502898,331693,244891,217234,149219,109751,77219,52546,4956,855816,1322818
MADHYA PRADESH,Ratlam,825880,485090,340790,224715,194131,129392,111461,86507,67192,5868,819266,1441419
MADHYA PRADESH,Ujjain,1240990,730817,510173,286534,280030,178295,159263,119586,111290,13282,1148280,1807559
MADHYA PRADESH,Shajapur,894612,543509,351103,271215,239081,141225,111366,75967,48671,3391,890916,1435707
MADHYA PRADESH,Dewas,925369,550716,374653,242508,225380,149522,125772,94403,55383,4991,897959,1463324
MADHYA PRADESH,Dhar,1077338,638479,438859,262090,244058,164576,134279,99882,66721,6543,978149,2000000
MADHYA PRADESH,Indore,2309130,1289631,1019499,428413,472233,384611,362209,300076,382658,36326,2366526,3084700
MADHYA PRADESH,Khargone (West Nimar),986234,575428,410806,287410,256930,152267,114246,89581,64150,5291,969875,1902494
MADHYA PRADESH,Barwani,549926,313642,236284,157337,137116,74067,59100,42649,30754,2581,503604,1328638
MADHYA PRADESH,Rajgarh,804245,488797,315448,239738,174381,103464,96386,72316,51499,4799,742583,1449541
MADHYA PRADESH,Vidisha,862918,512344,350574,242021,214603,123650,104007,65581,59814,6780,816456,1328767
MADHYA PRADESH,Bhopal,1660690,920314,740376,229082,303171,287198,211371,178165,266618,30845,1506450,1969031
MADHYA PRADESH,Sehore,780362,469208,311154,193885,179388,136284,120687,77541,50655,6755,765195,1273591
MADHYA PRADESH,Raisen,820220,479093,341127,237981,210402,144108,117908,69419,48384,4607,832809,1277686
MADHYA PRADESH,Betul,939769,529783,409986,239114,232532,176325,140402,105696,82761,5876,982706,1585804
MADHYA PRADESH,Harda,352550,203807,148743,90059,87733,60757,46556,31939,27126,3469,347639,525370
MADHYA PRADESH,Hoshangabad,810644,469199,341445,159703,183156,145076,119682,89589,84769,9279,791254,1135746
MADHYA PRADESH,Katni,790773,460583,330190,198447,207366,161727,112242,80935,53578,6658,820953,1286327
MADHYA PRADESH,Jabalpur,1756468,980307,776161,267932,352284,313910,268333,222987,235072,24872,1685390,2225419
MADHYA PRADESH,Narsimhapur,718785,413491,305294,160765,180070,128758,109996,82020,52763,5802,720174,1077161
MADHYA PRADESH,Dindori,378714,222759,155955,103002,113875,84065,49277,31104,15179,1674,398176,693831
MADHYA PRADESH,Mandla,604962,348033,256929,156711,170994,115632,82166,58066,35476,4587,623632,1000576
MADHYA PRADESH,Chhindwara,1294198,731294,562904,284113,336391,225747,215098,167946,112383,12141,1353819,2017265
MADHYA PRADESH,Seoni,864194,485341,378853,223650,241327,151636,116124,84398,55984,6427,879546,1338357
MADHYA PRADESH,Balaghat,1147623,626468,521155,290699,312640,235251,168635,126308,74213,7414,1215160,1708575
MADHYA PRADESH,Guna,653980,400537,253443,197902,157141,84560,79924,50724,42147,6451,618849,1196883
MADHYA PRADESH,Ashoknagar,469109,290304,178805,148647,117053,62802,51499,29551,22791,3466,435809,795334
MADHYA PRADESH,Shahdol,604194,348761,255433,161972,154282,128427,80402,60915,46513,5352,637863,1060599
MADHYA PRADESH,Anuppur,436595,254120,182475,113208,115716,93450,58536,42743,31646,3066,458365,730098
MADHYA PRADESH,Sidhi,600785,353030,247755,185550,168224,129344,80312,60845,33067,3896,661238,1138710
MADHYA PRADESH,Singrauli,585054,359923,225131,189929,150446,103971,61089,42434,30597,7449,585915,1103362
MADHYA PRADESH,Jhabua,352081,214582,137499,98308,79781,40466,38236,28990,20240,1973,307994,1083658
MADHYA PRADESH,Alirajpur,209754,120905,88849,43866,44457,22410,18213,15358,10040,1028,155372,814056
MADHYA PRADESH,Khandwa (East Nimar),731615,432259,299356,203486,201537,115166,77010,56847,42771,4970,701787,1253611
MADHYA PRADESH,Burhanpur,408679,233073,175606,107547,119468,69765,57058,42618,28237,4761,429454,747416
GUJARAT,Kachchh,1252319,739239,513080,246956,469402,141345,157284,61366,60386,14062,1150801,1732753
GUJARAT,Banas Kantha,1704923,1048402,656521,366867,859436,159433,226765,105372,66950,14451,1799274,3006650
GUJARAT,Patan,837913,494631,343282,168990,364667,78731,129584,57494,46355,11111,856932,1309823
GUJARAT,Mahesana,1502645,847499,655146,260278,467128,183468,266108,139208,130723,27391,1474304,1908801
GUJARAT,Sabar Kantha,1578734,918625,660109,214062,597667,211423,333650,198963,110817,24745,1691327,2356385
GUJARAT,Gandhinagar,1030494,582686,447808,136131,363156,133594,196456,95730,108400,16088,1049555,1296548
GUJARAT,Ahmadabad,5435760,3025463,2410297,761358,1614370,805199,1135058,549188,839295,100831,5805299,6934861
GUJARAT,Surendranagar,1093626,643221,450405,234873,482679,165406,172947,61164,58389,14501,1189959,1683386
GUJARAT,Rajkot,2725056,1514075,1210981,383780,913928,402240,540278,204306,266295,29924,2740751,3479411
GUJARAT,Jamnagar,1396534,795140,601394,255785,491009,194057,199634,74029,87523,18573,1320610,1823483
GUJARAT,Porbandar,393678,221621,172057,50588,150643,71637,63458,25119,22458,5260,389163,526282
GUJARAT,Junagadh,1842818,1046981,795837,271762,700258,294811,311849,137505,139957,30127,1886269,2555291
GUJARAT,Amreli,995459,558180,437279,230474,412251,120625,149478,66785,50999,8582,1039194,1419789
GUJARAT,Bhavnagar,1887255,1087371,799884,422461,929286,266953,281250,96241,93391,13946,2103528,2612192
GUJARAT,Anand,1551253,874481,676772,257524,560542,229013,283571,127459,110351,20487,1588947,1949453
GUJARAT,Kheda,1660243,942480,717763,295057,641541,250044,310341,148530,84223,19498,1749234,2231312
GUJARAT,Panch Mahals,1440805,858054,582751,255905,601358,205420,283648,139773,71810,17958,1575872,2357454
GUJARAT,Dohad,1007171,599035,408136,214098,392739,114168,156556,95794,41458,9656,1024469,2071557
GUJARAT,Vadodara,2893080,1614087,1278993,396624,865726,457662,504732,268451,314960,60177,2868332,3778551
GUJARAT,Narmada,370336,211767,158569,76197,146661,58188,52687,28396,14748,3451,380328,573108
GUJARAT,Bharuch,1118276,623047,495229,161675,367060,164765,188539,83895,74380,16036,1056350,1330179
GUJARAT,The Dangs,140968,77314,63654,43639,59954,17736,14872,7560,3490,2215,149466,240626
GUJARAT,Navsari,1001909,539471,462438,145678,266733,140235,190861,112460,85041,26012,967020,1228976
GUJARAT,Valsad,1170657,655528,515129,165459,303197,171712,212318,123281,90912,26987,1093866,1499794
GUJARAT,Surat,4571410,2687468,1883942,566242,1332690,807021,896927,433651,379505,79862,4495898,5438048
GUJARAT,Tapi,490036,269007,221029,84559,174139,75545,86580,49482,31743,8767,510815,802917
DAMAN AND DIU,Diu,38058,20327,17731,1872,7668,8545,9051,4367,1906,635,34044,44779
DAMAN AND DIU,Daman,150348,104316,46032,8957,28094,30406,26991,14170,9128,1995,119741,140382
DADRA AND NAGAR HAVELI,Dadra AND Nagar Haveli,223230,142521,80709,24701,69140,32004,37809,22700,19655,3566,209575,300630
MAHARASHTRA,Nandurbar,906509,512099,394410,166664,218718,121404,160961,113019,58461,9248,848475,1639088
MAHARASHTRA,Dhule,1293916,723388,570528,200494,323641,208571,290656,182739,114931,14526,1335558,1985126
MAHARASHTRA,Jalgaon,2891882,1629223,1262659,482462,735730,532587,627198,375643,229987,31008,3014615,4017665
MAHARASHTRA,Buldana,1879874,1048892,830982,315408,457067,400342,406379,228266,113783,19619,1940864,2541300
MAHARASHTRA,Akola,1411281,758977,652304,231841,328367,275264,291391,205723,112574,15157,1460317,1813004
MAHARASHTRA,Washim,869917,487703,382214,166509,238985,160331,162762,116032,47865,7294,899778,1191303
MAHARASHTRA,Amravati,2251875,1207104,1044771,326195,468853,463051,525116,346876,203273,16148,2349512,2827586
MAHARASHTRA,Wardha,1019458,552617,466841,140470,186781,201471,225208,158055,93772,7017,1012774,1224828
MAHARASHTRA,Nagpur,3673808,1959220,1714588,325084,666693,812381,790443,542228,493236,73475,3703540,4305087
MAHARASHTRA,Bhandara,899860,488709,411151,115150,187870,208902,204435,153749,67061,12452,949619,1185143
MAHARASHTRA,Gondiya,1004243,542837,461406,138457,237888,231153,225595,159570,57923,9620,1060206,1316755
MAHARASHTRA,Gadchiroli,708365,395110,313255,108850,145767,139482,140345,95911,35809,4154,670318,1030547
MAHARASHTRA,Chandrapur,1578615,872565,706050,243773,316192,337320,351610,241179,126488,15040,1631602,2148330
MAHARASHTRA,Yavatmal,2022574,1115980,906594,391944,562739,382001,389924,245819,123074,21889,2117390,2835594
MAHARASHTRA,Nanded,2189425,1255222,934203,416869,691348,368723,416761,255650,156225,21729,2327305,3211931
MAHARASHTRA,Hingoli,790743,450551,340192,175736,266649,127246,136075,74544,38698,5932,824880,1156268
MAHARASHTRA,Parbhani,1157814,666291,491523,229217,396713,204316,229103,116041,81333,9703,1266426,1819069
MAHARASHTRA,Jalna,1195523,699428,496095,271061,422207,218189,225331,120715,64060,9724,1331287,1877267
MAHARASHTRA,Aurangabad,2503837,1430936,1072901,381695,686271,422964,537936,310762,253253,19101,2611982,3431716
MAHARASHTRA,Nashik,4345366,2397538,1947828,544346,1038955,851714,830070,485052,373100,97219,4220456,5702234
MAHARASHTRA,Thane,8227161,4591396,3635765,712171,1530916,1588196,1751284,1080597,961719,114453,7739336,9431358
MAHARASHTRA,Mumbai Suburban,7575485,4223029,3352456,512268,1140066,1628031,1914168,1091433,1183117,189063,7658146,8769239
MAHARASHTRA,Mumbai,2509022,1410680,1098342,118967,399792,603937,665263,378764,343374,57044,2567141,2829453
MAHARASHTRA,Raigarh,1939994,1059692,880302,231263,407662,335886,441072,221410,204507,19940,1861740,2344160
MAHARASHTRA,Pune,7171723,3940210,3231513,559840,1234549,1383055,1414563,867256,1086650,190336,6736249,8089326
MAHARASHTRA,Ahmadnagar,3151890,1773355,1378535,483996,833691,580959,745895,411908,315842,32304,3404595,4465866
MAHARASHTRA,Bid,1718507,987185,731322,309704,436446,280800,316758,206530,129996,11438,1691672,2513279
MAHARASHTRA,Latur,1650672,932432,718240,268627,423711,296910,380344,224998,153256,18106,1765952,2362165
MAHARASHTRA,Osmanabad,1137810,644304,493506,183972,300965,201646,260772,139479,96847,9913,1193594,1633957
MAHARASHTRA,Solapur,2910676,1651266,1259410,390337,788150,535848,643327,328020,236302,29051,2951035,3927830
MAHARASHTRA,Satara,2225694,1201034,1024660,288427,495822,407977,556706,299993,243457,20884,2313266,2858689
MAHARASHTRA,Ratnagiri,1199392,619012,580380,163025,378554,269872,247257,111600,65700,15429,1251437,1571059
MAHARASHTRA,Sindhudurg,666067,348289,317778,86480,165284,134734,175070,89023,48418,3451,702460,824382
MAHARASHTRA,Kolhapur,2825845,1559760,1266085,321457,622362,487227,698604,395234,335413,40828,2901125,3679125
MAHARASHTRA,Sangli,2049467,1121550,927917,208511,507318,459156,453404,244804,214003,36983,2124179,2703218
ANDHRA PRADESH,Adilabad,1483347,856350,626997,232470,344167,281752,225957,143143,100226,19277,1346992,2377632
ANDHRA PRADESH,Nizamabad,1389810,790214,599596,269487,421399,338668,396396,223365,141850,13382,1804547,2846409
ANDHRA PRADESH,Karimnagar,2206829,1257238,949591,340372,453505,482842,463403,293493,256633,35312,2325560,3605953
ANDHRA PRADESH,Medak,1637137,953406,683731,324267,503713,481984,373729,201928,127493,16466,2029580,3229398
ANDHRA PRADESH,Hyderabad,2892155,1542688,1349467,230962,596591,685215,811501,517425,558090,45937,3445721,4002623
ANDHRA PRADESH,Rangareddy,3538028,1948784,1589244,457916,756588,809283,821821,598940,740896,57436,4242880,5401353
ANDHRA PRADESH,Mahbubnagar,1940646,1158386,782260,419379,596134,441585,308575,169083,98227,16121,2049104,3653423
ANDHRA PRADESH,Nalgonda,2001019,1160757,840262,369537,518669,471233,367424,238695,196134,27003,2188695,3483506
ANDHRA PRADESH,Warangal,2065023,1179790,885233,314252,457529,454322,430242,279234,248942,27663,2212184,3403436
ANDHRA PRADESH,Khammam,1630234,901640,728594,295639,346118,329630,238811,154774,160804,25456,1551232,2426504
ANDHRA PRADESH,Srikakulam,1495381,857824,637557,291793,348354,319244,251521,146721,121213,21031,1499877,2509869
ANDHRA PRADESH,Vizianagaram,1238388,707503,530885,250446,300057,257468,186576,115144,103591,27041,1240323,2272006
ANDHRA PRADESH,Visakhapatnam,2568249,1422878,1145371,414636,568178,649271,541942,329770,289734,44164,2837695,4256546
ANDHRA PRADESH,East Godavari,3288577,1716933,1571644,669420,947606,797497,521562,271809,263023,47702,3518619,5043222
ANDHRA PRADESH,West Godavari,2652389,1379223,1273166,595331,718960,585595,415178,215863,207586,33329,2771842,3800609
ANDHRA PRADESH,Krishna,3009718,1598959,1410759,618101,692968,630603,531821,312753,328454,54728,3169428,4521927
ANDHRA PRADESH,Guntur,2960441,1634726,1325715,736270,845810,674957,453446,246580,221924,30279,3209266,4683615
ANDHRA PRADESH,Prakasam,1904435,1107686,796749,489805,495556,368919,249034,142026,133627,21976,1900943,3119253
ANDHRA PRADESH,Sri Potti Sriramulu Nellore,1832189,1011922,820267,437438,451130,370710,267243,161031,148394,27865,1863811,2804596
ANDHRA PRADESH,Y.S.R.,1716766,994699,722067,408650,509166,413364,258798,140145,116330,16231,1862684,2756341
ANDHRA PRADESH,Kurnool,2127161,1246369,880792,521327,672951,466940,271828,152453,115504,19282,2220285,3738218
ANDHRA PRADESH,Anantapur,2310960,1338474,972486,462273,720357,582075,331793,162175,144915,23341,2426929,3795998
ANDHRA PRADESH,Chittoor,2667878,1484794,1183084,522961,770836,673197,548336,265199,246409,36017,3062955,4233948
KARNATAKA,Belgaum,3052032,1725548,1326484,544564,1057297,609600,532584,279583,201884,56621,3282133,4628909
KARNATAKA,Bagalkot,1113412,641388,472024,242336,385986,147397,171505,115095,82319,25791,1170429,1779272
KARNATAKA,Bijapur,1248268,730566,517702,246391,430477,143199,182756,129109,96990,24569,1253491,2000470
KARNATAKA,Bidar,1042673,597198,445475,188998,474921,194233,181076,105347,54900,12885,1212360,1727755
KARNATAKA,Raichur,979769,577213,402556,147743,385673,163709,153346,82082,50463,14622,997638,1780764
KARNATAKA,Koppal,809085,468785,340300,222140,357098,127605,113028,72243,43967,10431,946512,1418694
KARNATAKA,Gadag,700177,397178,302999,121615,244640,112703,105150,63816,42053,12822,702799,1008937
KARNATAKA,Dharwad,1301664,711776,589888,252596,383041,185530,227113,143453,137768,34302,1363803,1792359
KARNATAKA,Uttara Kannada,1081906,582099,499807,198632,338390,183534,210270,108521,94767,22876,1156990,1434847
KARNATAKA,Haveri,1085443,603793,481650,240925,430529,201965,158442,84357,55310,16830,1188358,1571852
KARNATAKA,Bellary,1421621,813440,608181,275785,529576,219702,203139,121453,89475,29367,1468497,2256259
KARNATAKA,Chitradurga,1087392,607188,480204,188329,332648,196470,217567,132435,75262,22078,1164789,1617764
KARNATAKA,Davanagere,1308540,720637,587903,242130,446793,206686,269748,154781,123863,32375,1476376,1943790
KARNATAKA,Shimoga,1263016,674938,588078,191641,385978,292481,251095,132138,111753,18036,1383122,1738344
KARNATAKA,Udupi,926429,465704,460725,142493,286193,176260,178094,109663,107279,18444,1018426,1222454
KARNATAKA,Chikmagalur,818345,438257,380088,114570,257550,160083,177585,96470,72420,12631,891309,1095680
KARNATAKA,Tumkur,1813391,1006024,807367,270373,500593,386998,423738,213588,143735,30687,1969712,2655986
KARNATAKA,Bangalore,7512276,4078041,3434235,599794,1509693,1629870,2018079,1196965,1733274,198399,8886074,10190122
KARNATAKA,Mandya,1149649,638668,510981,145178,309476,226552,308624,157839,102838,19987,1270494,1775228
KARNATAKA,Hassan,1225256,668836,556420,182255,354480,232531,292369,147837,103152,27774,1340398,1741625
KARNATAKA,Dakshina Kannada,1666323,864019,802304,191317,520715,296110,309141,178989,185916,36295,1718483,2017329
KARNATAKA,Kodagu,412877,215302,197575,51287,111562,75291,86232,54939,43225,8251,430787,522139
KARNATAKA,Mysore,1962180,1063766,898414,207091,537686,404565,452412,222230,212541,26834,2063359,2810596
KARNATAKA,Chamarajanagar,565279,312957,252322,82487,204765,132421,109361,57053,34799,9600,630486,1032129
KARNATAKA,Gulbarga,1427368,828359,599009,177860,579057,270622,290570,153746,104256,20492,1596603,2480307
KARNATAKA,Yadgir,510003,306751,203252,98481,204926,77942,73599,40104,27728,4634,527414,1106456
KARNATAKA,Kolar,1016219,564110,452109,138015,289841,228422,225498,107929,71422,17961,1079088,1478177
KARNATAKA,Chikkaballapura,783222,442158,341064,100059,219778,193549,187040,80928,55056,6631,843041,1223443
KARNATAKA,Bangalore Rural,688749,385311,303438,100770,168165,126285,166677,82235,51015,10741,705888,910950
KARNATAKA,Ramanagara,674758,378461,296297,98447,187673,119218,155358,77233,46318,8802,693049,1017770
GOA,North Goa,663060,351738,311322,40968,101521,148792,153887,87513,86781,16601,636063,735601
GOA,South Goa,502427,264085,238342,29874,73039,119869,108989,64786,57460,9579,463596,552173
LAKSHADWEEP,Lakshadweep,52553,28023,24530,5641,13391,13836,13997,6642,3491,1059,58057,64010
KERALA,Kasaragod,1037492,516476,521016,115476,268084,230416,238900,122657,76192,16585,1068310,1281215
KERALA,Kannur,2138434,1012956,1125478,204713,487016,491844,540383,308670,217203,40277,2290106,2569458
KERALA,Wayanad,645585,328136,317449,65326,144896,137227,184266,87042,51111,8786,678654,809865
KERALA,Kozhikode,2615443,1266939,1348504,247996,564392,647221,630818,351267,250117,53166,2744977,3080497
KERALA,Malappuram,3311315,1597404,1713911,415601,770417,814285,933793,392867,203779,41344,3572086,4194431
KERALA,Palakkad,2239492,1122600,1116892,249198,492864,608176,572412,232109,180540,36370,2371669,2811603
KERALA,Thrissur,2678548,1282261,1396287,222627,445696,524387,821831,362657,338600,71535,2787333,3094998
KERALA,Ernakulam,2855676,1425723,1429953,212263,446380,554817,702511,389793,429880,113133,2848777,3117092
KERALA,Idukki,923010,471881,451129,79149,166604,209398,261237,136428,86136,19252,958204,1084793
KERALA,Kottayam,1749798,861592,888206,117681,271496,373998,475724,280720,221350,52339,1793308,1927701
KERALA,Alappuzha,1852797,890552,962245,133039,334339,418953,573306,274789,198858,58096,1991380,2155371
KERALA,Pathanamthitta,1062553,499181,563372,64054,146138,202197,371128,172884,123549,32477,1112427,1183480
KERALA,Kollam,2240273,1074345,1165928,172247,406592,562529,595191,307950,233402,64052,2341963,2573249
KERALA,Thiruvananthapuram,2785408,1354857,1430551,206328,460690,642470,682156,389161,381782,76129,2838716,3147758
TAMIL NADU,Thiruvallur,2791721,1495711,1296010,181452,461918,600731,622789,303091,451321,66378,2687680,3297728
TAMIL NADU,Chennai,3776276,1968079,1808197,167207,516445,720331,801050,464207,905515,67277,3642032,4061097
TAMIL NADU,Kancheepuram,3013382,1611461,1401921,183054,535947,608188,634172,312208,526886,67354,2867809,3546183
TAMIL NADU,Vellore,2773928,1504355,1269573,191963,721473,719731,641585,311434,308514,71127,2965827,3857257
TAMIL NADU,Tiruvannamalai,1626813,909803,717010,203879,442688,423135,343955,174560,158041,36454,1782712,2455139
TAMIL NADU,Viluppuram,2195776,1234479,961297,202930,646306,549742,508930,246856,229726,45680,2430170,3430072
TAMIL NADU,Salem,2285562,1285107,1000455,188672,571061,518763,457866,242306,296399,60365,2335432,3290477
TAMIL NADU,Namakkal,1176131,653312,522819,123573,297179,247516,214836,126468,169206,21582,1200360,1588778
TAMIL NADU,Erode,1492662,828300,664362,175017,345914,319484,269016,155344,215514,30391,1510680,2118683
TAMIL NADU,The Nilgiris,569647,299447,270200,47555,122821,130678,133569,76132,69657,8328,588740,703237
TAMIL NADU,Dindigul,1481834,816180,665654,207751,386421,372636,282628,153100,163050,29443,1595029,2075710
TAMIL NADU,Karur,727044,401726,325318,76629,190229,167466,146666,77874,85595,14951,759410,1036340
TAMIL NADU,Tiruchirappalli,2038981,1087765,951216,229415,444023,447474,418930,223178,291506,70392,2124918,2526067
TAMIL NADU,Perambalur,375823,208011,167812,85210,106751,85101,71650,41447,44025,9189,443373,552384
TAMIL NADU,Ariyalur,480604,269582,211022,60697,134123,113437,96860,53934,57524,16126,532701,766139
TAMIL NADU,Cuddalore,1815281,1000322,814959,169844,412237,418769,386652,186394,227530,67411,1868837,2502878
TAMIL NADU,Nagapattinam,1213008,640916,572092,136593,323359,313357,249630,122350,125639,35762,1306690,1560262
TAMIL NADU,Thiruvarur,946471,503085,443386,138960,250163,243773,203450,103908,99082,28166,1067502,1243066
TAMIL NADU,Thanjavur,1790998,944264,846734,138375,431983,419605,373111,178126,222410,49261,1812871,2273994
TAMIL NADU,Pudukkottai,1110545,608776,501769,97231,283299,270046,251855,121706,111731,31315,1167183,1614529
TAMIL NADU,Sivaganga,959744,526304,433440,101778,216931,236700,199263,103903,115894,23941,998410,1309522
TAMIL NADU,Madurai,2273430,1223810,1049620,234611,525151,532616,453509,250285,363152,39350,2398674,2847799
TAMIL NADU,Theni,870080,479403,390677,90590,219747,213496,156676,95231,101147,14674,891561,1162299
TAMIL NADU,Virudhunagar,1398788,760375,638413,163264,398670,317054,230321,138306,167506,35156,1450277,1853523
TAMIL NADU,Ramanathapuram,978946,536487,442459,246909,293886,236511,189132,105978,97405,16785,1186606,1293898
TAMIL NADU,Thoothukkudi,1349697,703106,646591,153922,372036,315817,227154,133010,155613,31525,1389077,1654109
TAMIL NADU,Tirunelveli,2273457,1210710,1062747,263517,618656,517646,390495,220088,247635,71437,2329474,2950484
TAMIL NADU,Kanniyakumari,1548738,780541,768197,134236,331559,314029,322511,226312,254107,43034,1625788,1836689
TAMIL NADU,Dharmapuri,917709,527599,390110,129778,240222,221194,177877,103367,112592,26069,1011099,1523923
TAMIL NADU,Krishnagiri,1187958,667062,520896,135813,290351,289026,276694,133744,137081,24128,1286837,1865561
TAMIL NADU,Coimbatore,2635907,1394790,1241117,220388,466745,523563,526165,273098,440520,53709,2504188,3024107
TAMIL NADU,Tiruppur,1760566,959623,800943,192583,444390,369432,298635,170870,179733,21436,1677079,2229526
PONDICHERRY,Yanam,39274,19919,19355,3804,10954,8806,8044,4101,3836,1315,40860,55783
PONDICHERRY,PONDICHERRY,726649,380946,345703,61364,127754,150478,152482,81519,134067,17367,725031,871892
PONDICHERRY,Mahe,36470,16610,19860,2948,6043,7930,8773,5711,4475,978,36858,39851
PONDICHERRY,Karaikal,154916,79903,75013,18943,32899,33458,29456,15930,18998,4877,154561,187278
ANDAMAN AND NICOBAR ISLANDS,Nicobars,25332,15397,9935,2406,5984,7699,6325,3668,1300,364,27746,37527
ANDAMAN AND NICOBAR ISLANDS,North  AND Middle Andaman,78683,43186,35497,16126,21215,21293,12707,10042,5133,809,87325,109747
ANDAMAN AND NICOBAR ISLANDS,South Andaman,190266,105794,84472,16301,33267,42741,42150,29910,22388,3077,189834,226123
