State,District,Workers,Male_Workers,Female_Workers,Main_Workers,Marginal_Workers,Non_Workers,Cultivator_Workers,Agricultural_Workers,Household_Workers,Other_Workers
JAMMU AND KASHMIR,Kupwara,229064,190899,38165,123837,105227,641290,34680,56759,7946,129679
JAMMU AND KASHMIR,Badgam,214866,162578,52288,132003,82863,538879,55299,36630,29102,93835
JAMMU AND KASHMIR,Leh(Ladakh),75079,53265,21814,57125,17954,58408,20869,1645,1020,51545
JAMMU AND KASHMIR,Kargil,51873,39839,12034,28941,22932,88929,8266,3763,1222,38622
JAMMU AND KASHMIR,Punch,161393,117677,43716,73247,88146,315442,54264,31583,3930,71616
JAMMU AND KASHMIR,Rajouri,290912,184752,106160,130377,160535,351503,136527,24016,4656,125713
JAMMU AND KASHMIR,Kathua,200431,161548,38883,142847,57584,416004,69533,21566,3952,105380
JAMMU AND KASHMIR,Baramula,304200,249581,54619,187959,116241,703839,57495,62246,15084,169375
JAMMU AND KASHMIR,Bandipore,149317,101380,47937,75173,74144,242915,28232,32882,20484,67719
JAMMU AND KASHMIR,Srinagar,407188,333151,74037,330547,76641,829641,12228,10408,20095,364457
JAMMU AND KASHMIR,Ganderbal,100890,73305,27585,52949,47941,196556,15337,19312,7630,58611
JAMMU AND KASHMIR,Pulwama,188420,138428,49992,98306,90114,372020,49746,34080,10615,93979
JAMMU AND KASHMIR,Shupiyan,87721,63931,23790,54703,33018,178494,47424,10835,3395,26067
JAMMU AND KASHMIR,Anantnag,389684,244032,145652,176800,212884,689008,140957,76364,16322,156041
JAMMU AND KASHMIR,Kulgam,159990,102317,57673,77812,82178,264493,69173,29928,6193,54696
JAMMU AND KASHMIR,Doda,151912,101144,50768,79377,72535,258024,69947,12199,1932,67834
JAMMU AND KASHMIR,Ramban,87212,68476,18736,52051,35161,196501,41394,8810,2538,34470
JAMMU AND KASHMIR,Kishtwar,82974,56779,26195,44718,38256,147722,39271,16296,1186,26221
JAMMU AND KASHMIR,Udhampur,243672,163845,79827,152442,91230,311313,113020,11396,2641,116615
JAMMU AND KASHMIR,Reasi,144767,88755,56012,88462,56305,169900,96147,4009,534,44077
JAMMU AND KASHMIR,Jammu,508622,417456,91166,410344,98278,1021336,68613,36873,10589,392547
JAMMU AND KASHMIR,Samba,92526,81952,10574,74129,18397,226372,16894,6105,1520,68007
HIMACHAL PRADESH,Chamba,294035,158791,135244,119632,174403,225045,196665,9193,4521,83656
HIMACHAL PRADESH,Kangra,675170,403756,271414,313915,361255,834905,303007,54849,15662,301652
HIMACHAL PRADESH,Lahul AND Spiti,19295,10763,8532,15190,4105,12269,11227,572,167,7329
HIMACHAL PRADESH,Kullu,269084,148829,120255,193876,75208,168819,197141,12372,2707,56864
HIMACHAL PRADESH,Mandi,572671,297464,275207,284154,288517,427106,387944,15822,7134,161771
HIMACHAL PRADESH,Hamirpur,241931,118724,123207,126153,115778,212837,147103,8824,3347,82657
HIMACHAL PRADESH,Una,215346,141612,73734,134482,80864,305827,84800,19604,3427,107515
HIMACHAL PRADESH,Bilaspur,205871,111543,94328,103406,102465,176085,127169,4138,2561,72003
HIMACHAL PRADESH,Solan,298737,190001,108736,219235,79502,281583,141267,10283,4969,142218
HIMACHAL PRADESH,Sirmaur,280083,169399,110684,193906,86177,249772,182958,10730,5313,81082
HIMACHAL PRADESH,Shimla,430926,258628,172298,311770,119156,383084,249786,26114,7967,147059
HIMACHAL PRADESH,Kinnaur,56273,33863,22410,46782,9491,27848,32995,2537,944,19797
PUNJAB,Gurdaspur,757138,637652,119486,625778,131360,1541185,147912,100684,30903,477639
PUNJAB,Kapurthala,284165,235562,48603,248208,35957,531003,55252,42387,9861,176665
PUNJAB,Jalandhar,774472,639484,134988,689592,84880,1419118,85695,66664,29762,592351
PUNJAB,Hoshiarpur,499822,412506,87316,411011,88811,1086803,89772,74362,15990,319698
PUNJAB,Shahid Bhagat Singh Nagar,204329,170252,34077,173507,30822,407981,42608,22626,9011,130084
PUNJAB,Fatehgarh Sahib,214783,182777,32006,192845,21938,385380,44245,21389,8048,141101
PUNJAB,Ludhiana,1284822,1053600,231222,1138654,146168,2213917,140737,98646,71667,973772
PUNJAB,Moga,359172,292379,66793,304880,54292,636574,91622,82397,18098,167055
PUNJAB,Firozpur,756695,596406,160289,618362,138333,1272379,191685,227971,14679,322360
PUNJAB,Muktsar,335326,272699,62627,287205,48121,566570,86565,111014,5187,132560
PUNJAB,Faridkot,221555,185049,36506,190415,31140,395953,53230,54058,8225,106042
PUNJAB,Bathinda,549986,432988,116998,452678,97308,838539,141535,128382,14938,265131
PUNJAB,Mansa,328512,230739,97773,247175,81337,441239,105963,90367,13442,118740
PUNJAB,Patiala,660267,549661,110606,570391,89876,1235419,113182,89123,23647,434315
PUNJAB,Amritsar,917856,735195,182661,787254,130602,1572800,124617,121599,41642,629998
PUNJAB,Tarn Taran,380702,313639,67063,316310,64392,738925,115853,81216,21328,162305
PUNJAB,Rupnagar,233676,186910,46766,194209,39467,450951,45640,21520,12321,154195
PUNJAB,Sahibzada Ajit Singh Nagar,355995,283367,72628,316236,39759,638633,40867,21791,13501,279836
PUNJAB,Sangrur,568758,485129,83629,499792,68966,1086411,157191,91799,18578,301190
PUNJAB,Barnala,209331,178163,31168,186434,22897,386196,60340,40460,5132,103399
CHANDIGARH,Chandigarh,404136,328159,75977,385929,18207,651314,2578,1687,4799,395072
UTTARAKHAND,Uttarkashi,157276,84265,73011,128367,28909,172810,117264,4387,3122,32503
UTTARAKHAND,Chamoli,180940,93832,87108,115115,65825,210665,121157,3845,5384,50554
UTTARAKHAND,Rudraprayag,113032,52339,60693,78950,34082,129253,83155,3200,2112,24565
UTTARAKHAND,Tehri Garhwal,280442,140821,139621,165912,114530,338489,187121,8129,4021,81171
UTTARAKHAND,Dehradun,582768,458834,123934,488161,94607,1113926,77176,38195,22992,444405
UTTARAKHAND,Garhwal,274152,147373,126779,164439,109713,413119,150607,13715,5635,104195
UTTARAKHAND,Pithoragarh,216490,113539,102951,145481,71009,266949,137332,5432,6055,67671
UTTARAKHAND,Bageshwar,123638,58708,64930,78085,45553,136260,85125,8985,2991,26537
UTTARAKHAND,Almora,298211,142460,155751,201078,97133,324295,207617,10274,4312,76008
UTTARAKHAND,Champawat,99566,60427,39139,62698,36868,160082,59993,4032,1570,33971
UTTARAKHAND,Nainital,376181,256935,119246,296424,79757,578424,137530,34742,9767,194142
UTTARAKHAND,Udham Singh Nagar,591458,444578,146880,450762,140696,1057444,122686,165250,26396,277126
UTTARAKHAND,Hardwar,578121,497810,80311,495152,82969,1312301,93660,103115,19955,361391
HARYANA,Panchkula,211479,164865,46614,182831,28648,349814,26682,12827,9870,162100
HARYANA,Ambala,372139,320120,52019,319475,52664,756211,52871,57293,15753,246222
HARYANA,Yamunanagar,389233,342343,46890,339024,50209,824972,61516,73251,12287,242179
HARYANA,Kurukshetra,336780,268556,68224,285904,50876,627875,68908,85890,6726,175256
HARYANA,Kaithal,373899,292696,81203,290663,83236,700405,128016,85651,9450,150782
HARYANA,Karnal,516062,411646,104416,411533,104529,989262,112288,133723,15311,254740
HARYANA,Panipat,412318,328667,83651,339016,73302,793119,72120,62358,15824,262016
HARYANA,Sonipat,523179,391085,132094,396763,126416,926822,142344,101733,18184,260918
HARYANA,Jind,523422,368277,155145,385851,137571,810730,230387,102071,9114,181850
HARYANA,Fatehabad,369083,263498,105585,286258,82825,572928,132250,97997,6558,132278
HARYANA,Sirsa,502003,369462,132541,399169,102834,793186,164297,147042,11952,178712
HARYANA,Hisar,691621,488321,203300,531227,160394,1052310,261120,144213,16097,270191
HARYANA,Bhiwani,623006,430678,192328,445675,177331,1011439,288543,103788,14855,215820
HARYANA,Rohtak,345967,272646,73321,288949,57018,715237,95732,36568,8521,205146
HARYANA,Jhajjar,326534,250020,76514,246457,80077,631871,112389,44845,9254,160046
HARYANA,Mahendragarh,338584,232935,105649,212402,126182,583504,149146,38320,7639,143479
HARYANA,Rewari,337727,235326,102401,250219,87508,562605,102698,28215,9782,197032
HARYANA,Gurgaon,544716,432456,112260,487441,57275,969716,56046,27097,18228,443345
HARYANA,Mewat,289964,224642,65322,204178,85786,799299,104237,55278,6023,124426
HARYANA,Faridabad,579229,476933,102296,495316,83913,1230504,27705,29288,32286,489950
HARYANA,Palwal,309563,241464,68099,216932,92631,733145,91506,60685,8566,148806
NCT OF DELHI,North West,1188545,1022419,166126,1135126,53419,2467994,11433,13289,35896,1127927
NCT OF DELHI,North,296446,257575,38871,283583,12863,591532,2187,1791,11028,281440
NCT OF DELHI,North East,661386,594353,67033,622443,38943,1580238,2235,2406,30738,626007
NCT OF DELHI,East,579692,486951,92741,555026,24666,1129654,1156,3094,19541,555901
NCT OF DELHI,New Delhi,59541,46940,12601,56471,3070,82463,121,275,1030,58115
NCT OF DELHI,Central,207374,177621,29753,195978,11396,374946,597,601,10902,195274
NCT OF DELHI,West,874320,732598,141722,839621,34699,1668923,2952,4358,29022,837988
NCT OF DELHI,South West,795352,667977,127375,749995,45357,1497606,9733,7753,18614,759252
NCT OF DELHI,South,924393,775592,148801,869086,55307,1807536,2984,5908,25081,890420
RAJASTHAN,Ganganagar,912672,596320,316352,680563,232109,1056496,268297,230438,13790,400147
RAJASTHAN,Hanumangarh,835260,512802,322458,642109,193151,939432,370452,166833,13839,284136
RAJASTHAN,Bikaner,986208,640572,345636,752768,233440,1377729,499223,103833,26244,356908
RAJASTHAN,Churu,902829,541404,361425,628381,274448,1136718,572644,87983,16594,225608
RAJASTHAN,Jhunjhunun,894649,541392,353257,592813,301836,1242396,521692,68878,13472,290607
RAJASTHAN,Alwar,1708542,994171,714371,1179461,529081,1965637,898891,216772,34562,558317
RAJASTHAN,Bharatpur,1071154,647198,423956,694929,376225,1477308,500994,238894,25068,306198
RAJASTHAN,Dhaulpur,523212,339110,184102,317617,205595,683304,229936,74342,12721,206213
RAJASTHAN,Karauli,628726,371058,257668,438337,190389,829522,335302,115367,9521,168536
RAJASTHAN,Sawai Madhopur,578068,343802,234266,418555,159513,757483,313358,88804,12070,163836
RAJASTHAN,Dausa,684495,398151,286344,506214,178281,949914,390960,76277,17185,200073
RAJASTHAN,Jaipur,2464893,1714947,749946,2060010,404883,4161285,744374,131523,91011,1497985
RAJASTHAN,Sikar,1006504,657854,348650,698711,307793,1670829,501311,87889,22776,394528
RAJASTHAN,Nagaur,1425882,857031,568851,985927,439955,1881861,734614,263401,29647,398220
RAJASTHAN,Jodhpur,1489741,965103,524638,1056479,433262,2197424,592370,242017,42412,612942
RAJASTHAN,Jaisalmer,288903,182565,106338,175383,113520,381016,132466,43872,6835,105730
RAJASTHAN,Barmer,1202482,696240,506242,741367,461115,1401269,754260,132696,30565,284961
RAJASTHAN,Jalor,896644,494906,401738,660719,235925,932086,493355,158013,21867,223409
RAJASTHAN,Sirohi,419829,272196,147633,313292,106537,616517,124080,97823,9443,188483
RAJASTHAN,Pali,842327,523077,319250,605288,237039,1195246,243491,237280,26119,335437
RAJASTHAN,Ajmer,1053722,686149,367573,827181,226541,1529330,298856,145523,35602,573741
RAJASTHAN,Tonk,649161,371848,277313,495797,153364,772165,326083,113426,16004,193648
RAJASTHAN,Bundi,526091,314806,211285,361070,165021,584815,250453,111388,11172,153078
RAJASTHAN,Bhilwara,1148165,674589,473576,883329,264836,1260358,555168,163052,30149,399796
RAJASTHAN,Rajsamand,550831,319534,231297,362584,188247,605766,207582,106587,13505,223157
RAJASTHAN,Dungarpur,641515,346624,294891,216411,425104,747037,227849,184330,12514,216822
RAJASTHAN,Banswara,916574,482236,434338,542983,373591,880911,546569,199370,19818,150817
RAJASTHAN,Chittaurgarh,802755,456632,346123,656904,145851,741583,453201,123469,15435,210650
RAJASTHAN,Kota,748811,534650,214161,577548,171263,1202203,140262,134992,25125,448432
RAJASTHAN,Baran,552583,329754,222829,359785,192798,670172,216538,185037,15258,135750
RAJASTHAN,Jhalawar,685950,402825,283125,475653,210297,725179,328714,209772,11199,136265
RAJASTHAN,Udaipur,1365783,835839,529944,822355,543428,1702637,539106,302968,33535,490174
RAJASTHAN,Pratapgarh,481294,251691,229603,327445,153849,386554,306419,96815,5516,72544
UTTAR PRADESH,Saharanpur,1037344,911136,126208,882701,154643,2429038,221567,273050,34032,508695
UTTAR PRADESH,Muzaffarnagar,1291644,1081569,210075,1085491,206153,2851868,336049,323641,45952,586002
UTTAR PRADESH,Bijnor,1088036,921497,166539,839778,248258,2594677,232158,311489,52549,491840
UTTAR PRADESH,Moradabad,1417811,1193439,224372,1104968,312843,3354195,368638,338384,88733,622056
UTTAR PRADESH,Rampur,737261,609693,127568,564266,172995,1598558,214187,230238,54238,238598
UTTAR PRADESH,Jyotiba Phule Nagar,599089,459037,140052,453567,145522,1241132,217672,131877,31600,217940
UTTAR PRADESH,Meerut,1090539,898810,191729,890810,199729,2353150,196068,153995,63096,677380
UTTAR PRADESH,Baghpat,416695,342604,74091,334519,82176,886353,124718,74500,20347,197130
UTTAR PRADESH,Ghaziabad,1520538,1231615,288923,1252911,267627,3161107,158868,123680,83672,1154318
UTTAR PRADESH,Gautam Buddha Nagar,569109,443384,125725,458492,110617,1079006,72668,48845,35400,412196
UTTAR PRADESH,Bulandshahr,1173260,897815,275445,885216,288044,2325911,332475,241137,65937,533711
UTTAR PRADESH,Aligarh,1174361,929337,245024,865799,308562,2499528,281501,267197,78566,547097
UTTAR PRADESH,Mahamaya Nagar,484115,398126,85989,337295,146820,1080593,124231,154720,32402,172762
UTTAR PRADESH,Mathura,840939,635142,205797,594799,246140,1706245,235886,179248,44453,381352
UTTAR PRADESH,Agra,1389844,1119701,270143,1050562,339282,3028953,285471,234455,94184,775734
UTTAR PRADESH,Firozabad,761521,621840,139681,573649,187872,1736635,184595,150221,59942,366763
UTTAR PRADESH,Mainpuri,560840,466067,94773,424782,136058,1307689,270888,137174,24784,127994
UTTAR PRADESH,Budaun,1107343,939616,167727,875763,231580,2574553,575903,258758,40122,232560
UTTAR PRADESH,Bareilly,1401971,1153006,248965,1043912,358059,3046388,365985,326376,131699,577911
UTTAR PRADESH,Pilibhit,618605,534939,83666,463415,155190,1412402,216476,224192,22782,155155
UTTAR PRADESH,Shahjahanpur,892214,783313,108901,699503,192711,2114324,344973,275192,31141,240908
UTTAR PRADESH,Kheri,1264718,1058483,206235,958249,306469,2756525,529223,422142,47837,265516
UTTAR PRADESH,Sitapur,1422602,1171252,251350,1023642,398960,3061390,571097,473554,70971,306980
UTTAR PRADESH,Hardoi,1318946,1091952,226994,969871,349075,2773899,596813,406830,59649,255654
UTTAR PRADESH,Unnao,1124744,851014,273730,761831,362913,1983623,450123,332663,49243,292715
UTTAR PRADESH,Lucknow,1542806,1226399,316407,1152285,390521,3047032,175578,203029,99863,1064336
UTTAR PRADESH,Rae Bareli,1204710,867393,337317,644869,559841,2200849,316891,507882,60774,319163
UTTAR PRADESH,Farrukhabad,592267,494545,97722,474686,117581,1292937,245089,135679,43528,167971
UTTAR PRADESH,Kannauj,524676,430934,93742,419027,105649,1131940,239350,129517,51330,104479
UTTAR PRADESH,Etawah,506072,413713,92359,361588,144484,1075738,170827,158026,20803,156416
UTTAR PRADESH,Auraiya,442023,364543,77480,325721,116302,937522,166731,151727,12533,111032
UTTAR PRADESH,Kanpur Dehat,628864,493991,134873,448651,180213,1167320,224986,234069,20783,149026
UTTAR PRADESH,Kanpur Nagar,1572232,1299871,272361,1229166,343066,3009036,198547,258790,68738,1046157
UTTAR PRADESH,Jalaun,620764,470969,149795,420266,200498,1069210,196613,243035,26109,155007
UTTAR PRADESH,Jhansi,814914,565357,249557,560041,254873,1183689,228881,248072,48648,289313
UTTAR PRADESH,Lalitpur,503351,326783,176568,357033,146318,718241,267580,131354,14882,89535
UTTAR PRADESH,Hamirpur,443655,308527,135128,290375,153280,660630,130314,181449,19876,112016
UTTAR PRADESH,Mahoba,349676,237153,112523,238712,110964,526282,114244,130422,13523,91487
UTTAR PRADESH,Banda,701689,485314,216375,483232,218457,1097721,251755,273458,19098,157378
UTTAR PRADESH,Chitrakoot,394197,254977,139220,282614,111583,597533,160094,150695,12555,70853
UTTAR PRADESH,Fatehpur,1063929,713736,350193,670156,393773,1568804,328758,425366,51555,258250
UTTAR PRADESH,Pratapgarh,1066601,704569,362032,553013,513588,2142540,305746,386563,68642,305650
UTTAR PRADESH,Kaushambi,639086,402644,236442,415312,223774,960510,141102,321410,30491,146083
UTTAR PRADESH,Allahabad,2111907,1426110,685797,1286732,825175,3842484,474283,541146,185877,910601
UTTAR PRADESH,Bara Banki,1192850,871241,321609,834294,358556,2067849,458479,421973,77235,235163
UTTAR PRADESH,Faizabad,831209,597888,233321,496579,334630,1639787,260406,272734,43505,254564
UTTAR PRADESH,Ambedkar Nagar,787398,547406,239992,440998,346400,1610490,213814,301120,58520,213944
UTTAR PRADESH,Sultanpur,1242632,869838,372794,690967,551665,2554485,338890,501634,85785,316323
UTTAR PRADESH,Bahraich,1152160,895576,256584,743452,408708,2335571,430227,482897,37965,201071
UTTAR PRADESH,Shrawasti,403755,293981,109774,232762,170993,713606,163449,165118,18494,56694
UTTAR PRADESH,Balrampur,760253,534332,225921,458727,301526,1388412,276614,328768,29916,124955
UTTAR PRADESH,Gonda,1170552,855848,314704,739663,430889,2263367,440340,431532,65299,233381
UTTAR PRADESH,Siddharthnagar,878898,583633,295265,447943,430955,1680399,298360,395993,35756,148789
UTTAR PRADESH,Basti,783688,558642,225046,443724,339964,1680776,296928,282260,36856,167644
UTTAR PRADESH,Sant Kabir Nagar,539469,383482,155987,265453,274016,1175714,149604,241825,28884,119156
UTTAR PRADESH,Mahrajganj,994253,659465,334788,439293,554960,1690450,229847,532486,43015,188905
UTTAR PRADESH,Gorakhpur,1351629,1016876,334753,746381,605248,3089266,255660,454931,82965,558073
UTTAR PRADESH,Kushinagar,1116973,804857,312116,523258,593715,2447571,265686,528388,57049,265850
UTTAR PRADESH,Deoria,876246,639073,237173,455382,420864,2224700,238237,291016,50418,296575
UTTAR PRADESH,Azamgarh,1372032,941890,430142,784272,587760,3241881,425630,452055,115991,378356
UTTAR PRADESH,Mau,696747,475413,221334,396438,300309,1509221,145225,212343,118614,220565
UTTAR PRADESH,Ballia,1019483,723060,296423,569522,449961,2220291,206228,384432,72194,356629
UTTAR PRADESH,Jaunpur,1437375,934157,503218,896547,540828,3056829,540762,436792,88404,371417
UTTAR PRADESH,Ghazipur,1204602,808700,395902,766881,437721,2415666,368943,435934,68254,331471
UTTAR PRADESH,Chandauli,652543,462971,189572,341927,310616,1300213,125980,248674,58552,219337
UTTAR PRADESH,Varanasi,1220708,921234,299474,920761,299947,2456133,197952,182146,168764,671846
UTTAR PRADESH,Sant Ravidas Nagar (Bhadohi),470608,343155,127453,286978,183630,1107605,94402,104419,62665,209122
UTTAR PRADESH,Mirzapur,881996,613061,268935,537091,344905,1614974,178132,334372,80246,289246
UTTAR PRADESH,Sonbhadra,730399,463611,266788,397196,333203,1132160,141007,371261,29417,188714
UTTAR PRADESH,Etah,545984,440244,105740,415476,130508,1228496,242396,131779,28396,143413
UTTAR PRADESH,Kanshiram Nagar,472765,375213,97552,354257,118508,963954,229088,107094,22492,114091
BIHAR,Pashchim Champaran,1478947,999282,479665,797544,681403,2456095,217539,998833,38691,223884
BIHAR,Purba Champaran,1737539,1260774,476765,1132789,604750,3361832,349032,1057417,46164,284926
BIHAR,Sheohar,216372,166693,49679,137804,78568,439874,38727,136334,9119,32192
BIHAR,Sitamarhi,1114583,865929,248654,753645,360938,2308991,216012,635907,37932,224732
BIHAR,Madhubani,1636938,1105947,530991,1074091,562847,2850441,396880,940642,54934,244482
BIHAR,Supaul,877682,551718,325964,472649,405033,1351394,201882,554271,22555,98974
BIHAR,Araria,1069893,708391,361502,696410,373483,1741676,222913,691947,24367,130666
BIHAR,Kishanganj,529064,421192,107872,384416,144648,1161336,107862,321867,11633,87702
BIHAR,Purnia,1143318,803275,340043,776385,366933,2121301,197424,745015,28840,172039
BIHAR,Katihar,1013566,760522,253044,667602,345964,2057463,168857,672291,20577,151841
BIHAR,Madhepura,777546,496046,281500,443507,334039,1224216,190809,484062,16347,86328
BIHAR,Saharsa,649898,456724,193174,363326,286572,1250763,164600,356833,18651,109814
BIHAR,Darbhanga,1223640,947927,275713,731347,492293,2713745,236673,642115,44846,300006
BIHAR,Muzaffarpur,1547586,1195308,352278,910304,637282,3253476,273436,769001,65253,439896
BIHAR,Gopalganj,728201,539586,188615,363111,365090,1833811,208959,338666,26049,154527
BIHAR,Siwan,932416,730396,202020,462104,470312,2398048,264928,376344,31244,259900
BIHAR,Saran,1040231,857660,182571,545520,494711,2911631,232097,493461,42103,272570
BIHAR,Vaishali,1060344,858648,201696,716006,344338,2434677,255017,502637,36958,265732
BIHAR,Samastipur,1343400,1037576,305824,907433,435967,2918166,299039,721629,47917,274815
BIHAR,Begusarai,938182,715345,222837,591811,346371,2032359,146035,430870,58167,303110
BIHAR,Khagaria,560805,398216,162589,306283,254522,1106081,104517,325731,20816,109741
BIHAR,Bhagalpur,983528,740056,243472,534129,449399,2054238,135161,475228,60461,312678
BIHAR,Banka,771080,517817,253263,374097,396983,1263683,172440,462614,26680,109346
BIHAR,Munger,426658,327453,99205,233402,193256,941107,45953,196449,16690,167566
BIHAR,Lakhisarai,326576,240494,86082,201866,124710,674336,78532,159970,13546,74528
BIHAR,Sheikhpura,224655,151569,73086,148002,76653,411687,54511,109696,9917,50531
BIHAR,Nalanda,1045420,703405,342015,740949,304471,1832233,221240,534021,52585,237574
BIHAR,Patna,1881886,1436411,445475,1371267,510619,3956579,271216,658203,85349,867118
BIHAR,Bhojpur,822493,640283,182210,512009,310484,1905914,190896,364875,47985,218737
BIHAR,Buxar,538322,402180,136142,328547,209775,1168030,132472,251790,26122,127938
BIHAR,Kaimur (Bhabua),511163,375959,135204,284646,226517,1115221,125070,268597,24880,92616
BIHAR,Rohtas,924879,707939,216940,542439,382440,2035039,218087,405544,48512,252736
BIHAR,Aurangabad,837770,599157,238613,480286,357484,1702303,178525,426096,40652,192497
BIHAR,Gaya,1664062,1076170,587892,1007057,657005,2727356,370759,783505,87178,422620
BIHAR,Nawada,817041,539439,277602,508509,308532,1402105,216400,397505,40018,163118
BIHAR,Jamui,727571,452288,275283,445352,282219,1032834,156491,331466,105637,133977
BIHAR,Jehanabad,365378,266423,98955,251690,113688,759935,86108,179519,15075,84676
BIHAR,Arwal,236354,167991,68363,161277,75077,464489,49127,144698,6758,35771
SIKKIM,North  District,23359,15935,7424,17216,6143,20350,7313,2262,332,13452
SIKKIM,West District,70348,40772,29576,51225,19123,66087,40797,8053,1403,20095
SIKKIM,South District,74753,45300,29453,50898,23855,72097,37802,4188,1004,31759
SIKKIM,East District,139678,92351,47327,111058,28620,143905,31489,11483,2404,94302
ARUNACHAL PRADESH,Tawang,28561,19554,9007,24430,4131,21416,7631,1581,114,19235
ARUNACHAL PRADESH,West Kameng,42493,28313,14180,34752,7741,41454,14476,1705,801,25511
ARUNACHAL PRADESH,East Kameng,31710,16424,15286,27123,4587,46980,21835,1063,273,8539
ARUNACHAL PRADESH,Papum Pare,65772,41263,24509,51157,14615,110801,14104,1859,1543,48266
ARUNACHAL PRADESH,Upper Subansiri,33370,17898,15472,25717,7653,50078,21690,1846,481,9353
ARUNACHAL PRADESH,West Siang,49177,29156,20021,43000,6177,63097,28852,1384,298,18643
ARUNACHAL PRADESH,East Siang,40222,23591,16631,33578,6644,58992,20185,3565,493,15979
ARUNACHAL PRADESH,Upper Siang,17644,9968,7676,14524,3120,17676,9976,804,591,6273
ARUNACHAL PRADESH,Changlang,62966,39329,23637,50765,12201,85260,39732,4208,496,18530
ARUNACHAL PRADESH,Tirap,50169,27545,22624,44262,5907,61806,35967,1811,836,11555
ARUNACHAL PRADESH,Lower Subansiri,30202,17339,12863,22669,7533,52828,13656,1968,435,14143
ARUNACHAL PRADESH,Kurung Kumey,38044,18429,19615,24372,13672,54032,27417,2947,833,6847
ARUNACHAL PRADESH,Dibang Valley,3555,2228,1327,2525,1030,4449,1290,106,68,2091
ARUNACHAL PRADESH,Lower Dibang Valley,22326,14102,8224,19829,2497,31754,9687,3354,233,9052
ARUNACHAL PRADESH,Lohit,60945,38910,22035,50754,10191,84781,29909,7789,786,22461
ARUNACHAL PRADESH,Anjaw,10501,6224,4277,9264,1237,10666,6316,181,84,3920
NAGALAND,Mon,147654,79425,68229,104981,42673,102606,113473,10836,1608,21737
NAGALAND,Mokokchung,100067,57084,42983,81046,19021,94555,48925,9166,3798,38178
NAGALAND,Zunheboto,79466,41178,38288,49382,30084,61291,44723,11955,2025,20763
NAGALAND,Wokha,78412,42096,36316,63512,14900,87931,47473,6438,1965,22536
NAGALAND,Dimapur,151350,99645,51705,122358,28992,227461,24517,8990,5073,112770
NAGALAND,Phek,80277,41556,38721,63645,16632,83141,55091,3159,1275,20752
NAGALAND,Tuensang,98154,52931,45223,73518,24636,98442,75212,3913,1104,17925
NAGALAND,Longleng,30568,16273,14295,20944,9624,19916,22501,1309,598,6160
NAGALAND,Kiphire,31959,16780,15179,25830,6129,42045,21432,1259,749,8519
NAGALAND,Kohima,114825,68140,46685,99408,15417,153163,44684,2198,2072,65871
NAGALAND,Peren,61390,32249,29141,36555,24835,33829,39671,3739,2571,15409
MANIPUR,Senapati,233622,124143,109479,185725,47897,245526,175127,30369,4978,42307
MANIPUR,Tamenglong,70675,37237,33438,55979,14696,69976,48849,1924,1710,18192
MANIPUR,Churachandpur,122655,70594,52061,89779,32876,151488,64834,8282,5067,44472
MANIPUR,Bishnupur,109937,62807,47130,76423,33514,127462,34358,15109,11567,48903
MANIPUR,Thoubal,195319,109377,85942,133428,61891,226849,77331,33106,21017,63865
MANIPUR,Imphal West,213387,128540,84847,166009,47378,304605,37107,12870,19918,143492
MANIPUR,Imphal East,194848,117562,77286,145343,49505,261265,36355,20250,21826,116417
MANIPUR,Ukhrul,87929,46533,41396,67724,20205,96069,56815,3852,2233,25029
MANIPUR,Chandel,76238,42615,33623,53753,22485,67944,43255,8315,3040,21628
MIZORAM,Mamit,39339,24016,15323,36185,3154,47025,28669,2553,262,7855
MIZORAM,Kolasib,36672,22733,13939,29697,6975,47283,17992,5921,585,12174
MIZORAM,Aizawl,174636,104643,69993,151410,23226,225673,39266,11434,3360,120576
MIZORAM,Champhai,60342,34129,26213,53111,7231,65403,38336,5823,980,15203
MIZORAM,Serchhip,32397,18261,14136,29838,2559,32540,21804,1284,926,8383
MIZORAM,Lunglei,78292,46230,32062,62013,16279,83136,45439,10662,813,21378
MIZORAM,Lawngtlai,45566,28517,17049,38082,7484,72328,29189,3153,613,12611
MIZORAM,Saiha,19461,12211,7250,14694,4767,37113,8908,957,313,9283
TRIPURA,West Tripura,698178,500406,197772,524198,173980,1027561,115175,156108,25163,401732
TRIPURA,South Tripura,366845,253229,113616,258457,108388,509156,85530,111332,6375,163608
TRIPURA,Dhalai,155831,105657,50174,108259,47572,222399,45956,42201,2870,64804
TRIPURA,North Tripura,248667,186034,62633,186105,62562,445280,49286,43977,7088,148316
MEGHALAYA,West Garo Hills,255693,151914,103779,188371,67322,387598,120740,39725,7643,87585
MEGHALAYA,East Garo Hills,126073,72262,53811,83936,42137,191844,77390,19246,2475,26962
MEGHALAYA,South Garo Hills,53069,32826,20243,38397,14672,89265,28145,5565,1249,18110
MEGHALAYA,West Khasi Hills,163345,89694,73651,119803,43542,220116,84956,37184,2475,38730
MEGHALAYA,Ribhoi,106473,63871,42602,90875,15598,152367,55833,19989,1676,28975
MEGHALAYA,East Khasi Hills,326786,204303,122483,289576,37210,499136,76767,40889,2966,206164
MEGHALAYA,Jaintia Hills,154180,88839,65341,110617,43563,240944,50844,35766,2004,65566
ASSAM,Kokrajhar,341131,236322,104809,253110,88021,546011,156753,56330,12423,115625
ASSAM,Dhubri,669819,524898,144921,504998,164821,1279439,205305,171116,27822,265576
ASSAM,Goalpara,362573,267118,95455,266376,96197,645610,126549,75828,14346,145850
ASSAM,Barpeta,561824,445297,116527,439453,122371,1131798,205259,98946,30342,227277
ASSAM,Morigaon,351148,257984,93164,260968,90180,606275,157612,75984,14346,103206
ASSAM,Nagaon,979998,766728,213270,734993,245005,1843770,346123,196174,38122,399579
ASSAM,Sonitpur,770606,537195,233411,558325,212281,1153504,249123,114865,25719,380899
ASSAM,Lakhimpur,429995,282250,147745,283533,146462,612142,239377,43922,10983,135713
ASSAM,Dhemaji,316800,186577,130223,201364,115436,369333,231937,19181,7224,58458
ASSAM,Tinsukia,557196,366623,190573,410188,147008,770733,149482,47756,13241,346717
ASSAM,Dibrugarh,560557,368013,192544,391597,168960,765778,135194,61209,14362,349792
ASSAM,Sivasagar,485717,325071,160646,318950,166767,665333,138100,48468,14532,284617
ASSAM,Jorhat,498618,320746,177872,338635,159983,593638,145885,53153,31543,268037
ASSAM,Golaghat,479928,309104,170824,331210,148718,586960,190590,66616,15068,207654
ASSAM,Karbi Anglong,383441,246193,137248,260482,122959,572872,223020,60952,9861,89608
ASSAM,Dima Hasao,85028,56323,28705,68297,16731,129074,44480,4818,1492,34238
ASSAM,Cachar,608062,469752,138310,471259,136803,1128555,120356,68664,24466,394576
ASSAM,Karimganj,399171,319798,79373,293392,105779,829515,94348,67033,17435,220355
ASSAM,Hailakandi,214240,170792,43448,165193,49047,445056,65673,31248,7313,110006
ASSAM,Bongaigaon,255806,197542,58264,191671,64135,482998,83442,47406,9485,115473
ASSAM,Chirang,193894,128762,65132,139027,54867,288268,80328,35224,7672,70670
ASSAM,Kamrup,628954,428492,200462,421244,207710,888588,185803,99522,69106,274523
ASSAM,Kamrup Metropolitan,490932,375613,115319,413154,77778,763006,25250,16995,12463,436224
ASSAM,Nalbari,267623,210202,57421,196773,70850,504016,58070,34984,19302,155267
ASSAM,Baksa,406756,266611,140145,278297,128459,543319,149288,94591,20310,142567
ASSAM,Darrang,324843,246864,77979,241456,83387,603657,129456,81617,10542,103228
ASSAM,Udalguri,345030,230690,114340,253178,91852,486638,124824,72744,11801,135661
WEST BENGAL,Darjiling,683726,479586,204140,532855,150871,1163097,76178,66041,16579,524928
WEST BENGAL,Jalpaiguri,1512910,1091361,421549,1153765,359145,2359936,214932,349672,30090,918216
WEST BENGAL,Koch Bihar,1127977,845308,282669,886357,241620,1691109,364797,391875,40593,330712
WEST BENGAL,Uttar Dinajpur,1075626,799627,275999,824342,251284,1931508,257377,442328,37978,337943
WEST BENGAL,Dakshin Dinajpur,702987,499560,203427,526470,176517,973289,193276,279932,32290,197489
WEST BENGAL,Maldah,1537847,1086461,451386,1050995,486852,2450998,255182,545759,196687,540219
WEST BENGAL,Murshidabad,2589907,1985667,604240,2022083,567824,4513900,381076,842294,466007,900530
WEST BENGAL,Birbhum,1331603,1029770,301833,912844,418759,2170801,227254,611510,65062,427777
WEST BENGAL,Barddhaman,2911251,2293083,618168,2166742,744509,4806312,342166,973182,124558,1471345
WEST BENGAL,Nadia,1842607,1554090,288517,1595880,246727,3324993,308742,556134,169138,808593
WEST BENGAL,North Twenty Four Parganas,3571624,2945189,626435,3055630,515994,6438157,288058,599039,155762,2528765
WEST BENGAL,Hugli,2152870,1713608,439262,1714645,438225,3366275,259680,583380,111828,1197982
WEST BENGAL,Bankura,1466220,1050822,415398,916393,549827,2130454,309723,647374,61386,447737
WEST BENGAL,Puruliya,1249642,801254,448388,613398,636244,1680473,268800,492205,87560,401077
WEST BENGAL,Haora,1819845,1498170,321675,1496267,323578,3030184,80575,181662,297774,1259834
WEST BENGAL,Kolkata,1795740,1412466,383274,1576419,219321,2700954,16039,12388,68438,1698875
WEST BENGAL,South Twenty Four Parganas,2964494,2356571,607923,2003685,960809,5197467,355350,806562,240976,1561606
WEST BENGAL,Paschim Medinipur,2509159,1757358,751801,1510548,998611,3404298,572268,1105201,142602,689088
WEST BENGAL,Purba Medinipur,1910320,1516096,394224,1127312,783008,3185555,345215,702304,118816,743985
JHARKHAND,Garhwa,571431,335451,235980,175126,396305,751353,113561,328673,14487,114710
JHARKHAND,Chatra,397690,251213,146477,195502,202188,645196,119297,188513,14210,75670
JHARKHAND,Kodarma,257418,173993,83425,143324,114094,458841,83126,64275,7934,102083
JHARKHAND,Giridih,1036277,623946,412331,412912,623365,1409197,369913,362610,32544,271210
JHARKHAND,Deoghar,551467,383691,167776,297146,254321,940606,128656,209693,39361,173757
JHARKHAND,Godda,552191,344019,208172,235735,316456,761360,144603,307767,18719,81102
JHARKHAND,Sahibganj,490202,295690,194512,322572,167630,660365,109975,206902,43179,130146
JHARKHAND,Pakur,404584,234012,170572,252017,152567,495838,105334,150028,19471,129751
JHARKHAND,Dhanbad,844504,658851,185653,546714,297790,1839983,97118,103488,25889,618009
JHARKHAND,Bokaro,685368,507677,177691,380304,305064,1376962,137521,126406,21671,399770
JHARKHAND,Lohardaga,221332,121605,99727,103001,118331,240458,99780,80840,4449,36263
JHARKHAND,Purbi Singhbhum,837167,616249,220918,529578,307589,1456752,112059,209802,21438,493868
JHARKHAND,Palamu,713175,473042,240133,283702,429473,1226694,133585,380976,19911,178703
JHARKHAND,Latehar,313379,180106,133273,117311,196068,413599,103693,142729,9205,57752
JHARKHAND,Hazaribagh,654636,423472,231164,327316,327320,1079859,242460,172385,16150,223641
JHARKHAND,Ramgarh,312125,234202,77923,221112,91013,637318,90770,46815,8336,166204
JHARKHAND,Dumka,624779,367108,257671,237479,387300,696663,193402,303084,23106,105187
JHARKHAND,Jamtara,326631,214740,111891,122434,204197,464411,106008,135667,11547,73409
JHARKHAND,Ranchi,1142867,743967,398900,756176,386691,1771386,317487,267360,38452,519568
JHARKHAND,Khunti,259984,141123,118861,153087,106897,271901,166290,49448,9245,35001
JHARKHAND,Gumla,487508,264774,222734,278931,208577,537705,321272,97918,12771,55547
JHARKHAND,Simdega,288645,159867,128778,155510,133135,310933,158019,90232,8011,32383
JHARKHAND,Pashchimi Singhbhum,694863,392690,302173,343008,351855,807475,244172,267475,24825,158391
JHARKHAND,Saraikela-Kharsawan,430051,283281,146770,228598,201453,635005,116731,142966,10251,160103
ORISSA,Bargarh,762092,473305,288787,474390,287702,719163,216413,360650,48145,136884
ORISSA,Jharsuguda,247707,172018,75689,172069,75638,331798,40867,56809,15836,134195
ORISSA,Sambalpur,505840,313161,192679,336854,168986,535259,86800,160798,59288,198954
ORISSA,Debagarh,165435,92384,73051,83408,82027,147085,42660,82490,8087,32198
ORISSA,Sundargarh,873227,584687,288540,535112,338115,1220210,184273,253327,26970,408657
ORISSA,Kendujhar,766514,498077,268437,442497,324017,1035219,198044,310075,21314,237081
ORISSA,Mayurbhanj,1223534,697782,525752,548390,675144,1296204,238772,568755,113808,302199
ORISSA,Baleshwar,932707,684020,248687,618064,314643,1387822,288818,358214,28736,256939
ORISSA,Bhadrak,468599,409559,59040,328097,140502,1037738,155956,151377,14451,146815
ORISSA,Kendrapara,466890,386382,80508,322265,144625,973471,149264,143864,16544,157218
ORISSA,Jagatsinghapur,403649,325589,78060,290170,113479,733322,111320,110323,16357,165649
ORISSA,Cuttack,936365,761876,174489,696274,240091,1688105,138698,248298,51809,497560
ORISSA,Jajapur,552234,486091,66143,407564,144670,1274958,120881,186021,20938,224394
ORISSA,Dhenkanal,435533,340552,94981,277338,158195,757278,71230,163636,17312,183355
ORISSA,Anugul,526520,360947,165573,317547,208973,747301,107607,172414,35069,211430
ORISSA,Nayagarh,343633,284591,59042,229076,114557,619156,83022,120129,17557,122925
ORISSA,Khordha,792193,645880,146313,632625,159568,1459480,92662,116274,39471,543786
ORISSA,Puri,621676,498461,123215,450536,171140,1077054,172761,163942,25115,259858
ORISSA,Ganjam,1501772,990027,511745,900744,601028,2027259,284943,565448,56274,595107
ORISSA,Gajapati,293933,155907,138026,170371,123562,283884,65062,153199,5370,70302
ORISSA,Kandhamal,355349,193515,161834,167112,188237,377761,79221,162932,11946,101250
ORISSA,Baudh,219457,125627,93830,123724,95733,221705,63657,104685,11674,39441
ORISSA,Subarnapur,286661,181595,105066,170218,116443,323522,74005,139413,18756,54487
ORISSA,Balangir,720601,469956,250645,402227,318374,928396,166565,326416,28650,198970
ORISSA,Nuapada,305438,168155,137283,151694,153744,304944,94692,149834,8641,52271
ORISSA,Kalahandi,751930,447290,304640,376757,375173,824939,144991,436733,18453,151753
ORISSA,Rayagada,467122,258032,209090,227815,239307,500789,99265,248175,9959,109723
ORISSA,Nabarangapur,610906,342641,268265,279115,331791,610040,173086,328783,14409,94628
ORISSA,Koraput,693406,384053,309353,396460,296946,686241,207194,290626,14416,181170
ORISSA,Malkangiri,310666,170495,140171,179030,131636,302526,151260,106353,7725,45328
CHHATTISGARH,Koriya,307071,185483,121588,173057,134014,351846,118498,94648,4830,89095
CHHATTISGARH,Surguja,1155807,649888,505919,622589,533218,1204079,465287,523356,12643,154521
CHHATTISGARH,Jashpur,487360,263645,223715,291349,196011,364309,226866,197558,7553,55383
CHHATTISGARH,Raigarh,690167,429211,260956,484875,205292,803817,208313,323788,9959,148107
CHHATTISGARH,Korba,521186,333329,187857,350314,170872,685454,113071,221806,7899,178410
CHHATTISGARH,Janjgir - Champa,846466,478278,368188,461887,384579,773241,281266,402359,15828,147013
CHHATTISGARH,Bilaspur,1203197,715467,487730,826568,376629,1460432,276691,572292,21658,332556
CHHATTISGARH,Kabeerdham,404156,217073,187083,316976,87180,418370,167662,185850,3046,47598
CHHATTISGARH,Rajnandgaon,800092,436611,363481,595959,204133,737041,342116,290108,10847,157021
CHHATTISGARH,Durg,1496805,921729,575076,1206793,290012,1847067,392341,560415,22565,521484
CHHATTISGARH,Raipur,1757664,1099964,657700,1259138,498526,2306208,383279,708993,34078,631314
CHHATTISGARH,Mahasamund,499260,291858,207402,340802,158458,533494,139199,278073,6135,75853
CHHATTISGARH,Dhamtari,402895,226382,176513,335368,67527,396886,135435,182602,7310,77548
CHHATTISGARH,Uttar Bastar Kanker,389359,217513,171846,285536,103823,359582,194018,129142,7811,58388
CHHATTISGARH,Bastar,726531,404364,322167,394824,331707,686668,284472,287828,10821,143410
CHHATTISGARH,Narayanpur,71089,38186,32903,42056,29033,68731,44389,13820,939,11941
CHHATTISGARH,Dakshin Bastar Dantewada,286595,153294,133301,184285,102310,247043,165389,69385,2310,49511
CHHATTISGARH,Bijapur,134525,71591,62934,69338,65187,120705,66504,49859,1399,16763
MADHYA PRADESH,Sheopur,277455,183788,93667,196189,81266,410406,106745,115261,4166,51283
MADHYA PRADESH,Morena,675993,525329,150664,520970,155023,1289977,304674,148222,16354,206743
MADHYA PRADESH,Bhind,520768,455775,64993,422111,98657,1182237,231185,158266,9838,121479
MADHYA PRADESH,Gwalior,685311,548820,136491,559845,125466,1346725,130586,120348,22592,411785
MADHYA PRADESH,Datia,321160,225662,95498,247229,73931,465594,152903,93744,6839,67674
MADHYA PRADESH,Shivpuri,759281,481001,278280,577723,181558,966769,383340,220440,13079,142422
MADHYA PRADESH,Tikamgarh,655318,402776,252542,470432,184886,789848,305859,223852,15622,109985
MADHYA PRADESH,Chhatarpur,751797,481518,270279,553862,197935,1010578,302228,238364,26390,184815
MADHYA PRADESH,Panna,431998,275375,156623,276633,155365,584522,135445,198847,12201,85505
MADHYA PRADESH,Sagar,1006035,682077,323958,779093,226942,1372423,203600,378560,140458,283417
MADHYA PRADESH,Damoh,574595,367711,206884,389993,184602,689624,114611,250165,67383,142436
MADHYA PRADESH,Satna,911349,590487,320862,612510,298839,1317586,227967,371584,46056,265742
MADHYA PRADESH,Rewa,991946,617184,374762,630251,361695,1373160,258321,463506,50878,219241
MADHYA PRADESH,Umaria,289691,175698,113993,138600,151091,355067,65369,145690,8767,69865
MADHYA PRADESH,Neemuch,418682,245708,172974,358500,60182,407385,175602,136330,4020,102730
MADHYA PRADESH,Mandsaur,679723,397714,282009,535066,144657,660688,281465,266350,8556,123352
MADHYA PRADESH,Ratlam,690980,411446,279534,471139,219841,764089,218692,305946,11928,154414
MADHYA PRADESH,Ujjain,897442,569425,328017,682115,215327,1089422,289013,302003,19678,286748
MADHYA PRADESH,Shajapur,717871,431857,286014,508833,209038,794810,287924,303157,8809,117981
MADHYA PRADESH,Dewas,742676,451501,291175,528526,214150,821039,260222,310606,11816,160032
MADHYA PRADESH,Dhar,1027974,597079,430895,783019,244955,1157819,385522,437437,15830,189185
MADHYA PRADESH,Indore,1268195,939055,329140,1137251,130944,2008502,150907,185528,43584,888176
MADHYA PRADESH,Khargone (West Nimar),894119,518254,375865,756735,137384,978927,307085,425712,11524,149798
MADHYA PRADESH,Barwani,653897,365928,287969,525791,128106,731984,287704,267196,7451,91546
MADHYA PRADESH,Rajgarh,745603,429768,315835,471773,273830,800211,285095,330820,12123,117565
MADHYA PRADESH,Vidisha,550402,401583,148819,397283,153119,908473,168615,228308,12408,141071
MADHYA PRADESH,Bhopal,867457,644960,222497,706036,161421,1503604,73346,105195,24732,664184
MADHYA PRADESH,Sehore,586087,364559,221528,372150,213937,725245,201307,227026,9917,147837
MADHYA PRADESH,Raisen,517838,370366,147472,370241,147597,813759,138725,228151,17316,133646
MADHYA PRADESH,Betul,786980,453887,333093,511287,275693,788382,253602,358157,11849,163372
MADHYA PRADESH,Harda,230979,156852,74127,163781,67198,339486,68019,101256,6459,55245
MADHYA PRADESH,Hoshangabad,478082,345435,132647,361648,116434,763268,116440,181967,9982,169693
MADHYA PRADESH,Katni,543874,348410,195464,316144,227730,748168,112812,223902,31261,175899
MADHYA PRADESH,Jabalpur,1005624,705970,299654,744287,261337,1457665,106882,283636,69946,545160
MADHYA PRADESH,Narsimhapur,477818,323464,154354,358203,119615,614036,113866,257865,10594,95493
MADHYA PRADESH,Dindori,389925,203383,186542,250137,139788,314599,150084,190962,7958,40921
MADHYA PRADESH,Mandla,559649,300235,259414,325159,234490,495256,148931,318909,9453,82356
MADHYA PRADESH,Chhindwara,957984,582263,375721,673845,284139,1132938,283111,422668,14585,237620
MADHYA PRADESH,Seoni,684434,394660,289774,397575,286859,694697,173665,376404,11957,122408
MADHYA PRADESH,Balaghat,893014,488610,404404,530506,362508,808684,257785,459796,19245,156188
MADHYA PRADESH,Guna,514897,335454,179443,353671,161226,726622,213949,175615,12079,113254
MADHYA PRADESH,Ashoknagar,315270,231829,83441,241288,73982,529801,116913,122387,10559,65411
MADHYA PRADESH,Shahdol,493057,292402,200655,240811,252246,573006,95795,258991,14329,123942
MADHYA PRADESH,Anuppur,346471,207401,139070,227040,119431,402766,115448,130376,7051,93596
MADHYA PRADESH,Sidhi,461760,284289,177471,275482,186278,665273,102644,262030,15654,81432
MADHYA PRADESH,Singrauli,499439,304234,195205,348393,151046,678834,147732,228472,8856,114379
MADHYA PRADESH,Jhabua,515121,265489,249632,370641,144480,509927,329175,115649,5132,65165
MADHYA PRADESH,Alirajpur,366797,188698,178099,265029,101768,362202,256393,73693,4066,32645
MADHYA PRADESH,Khandwa (East Nimar),612976,369676,243300,492393,120583,697085,179337,306623,9852,117164
MADHYA PRADESH,Burhanpur,328339,211925,116414,274900,53439,429508,67799,156295,8077,96168
GUJARAT,Kachchh,776228,624704,151524,686937,89291,1316143,105876,183971,10802,475579
GUJARAT,Banas Kantha,1248600,836268,412332,1012080,236520,1871906,475585,350541,11812,410662
GUJARAT,Patan,554830,383074,171756,446240,108590,788904,136590,227080,6392,184768
GUJARAT,Mahesana,812064,588699,223365,698768,113296,1223000,189760,242969,10282,369053
GUJARAT,Sabar Kantha,1084878,681435,403443,795096,289782,1343711,366711,333867,10909,373391
GUJARAT,Gandhinagar,534976,408075,126901,451951,83025,856777,104147,129356,8600,292873
GUJARAT,Ahmadabad,2594952,2127547,467405,2332409,262543,4619273,142670,268954,54876,2128452
GUJARAT,Surendranagar,723500,504038,219462,586364,137136,1032768,185235,270861,9518,257886
GUJARAT,Rajkot,1479050,1159480,319570,1324783,154267,2325508,349357,214285,23780,891628
GUJARAT,Jamnagar,847440,646822,200618,721253,126187,1312679,264318,147193,11359,424570
GUJARAT,Porbandar,231169,174118,57051,195437,35732,354280,65702,48964,2371,114132
GUJARAT,Junagadh,1123709,801859,321850,942709,181000,1619373,367311,333996,9645,412757
GUJARAT,Amreli,657139,453642,203497,529153,127986,857051,232126,209935,6083,208995
GUJARAT,Bhavnagar,1150632,838781,311851,992140,158492,1729733,231796,334025,17996,566815
GUJARAT,Anand,844794,627561,217233,690031,154763,1247951,152412,346329,16460,329593
GUJARAT,Kheda,933983,674586,259397,722134,211849,1365902,239241,359842,12455,322445
GUJARAT,Panch Mahals,1097507,673565,423942,685141,412366,1293269,456768,376038,10771,253930
GUJARAT,Dohad,999124,540881,458243,553395,445729,1127962,388612,438597,8815,163100
GUJARAT,Vadodara,1693473,1233312,460161,1360660,332813,2472153,312126,570361,17680,793306
GUJARAT,Narmada,294795,174282,120513,193916,100879,295502,62823,188030,2594,41348
GUJARAT,Bharuch,627124,468919,158205,526541,100583,923895,78120,253577,8902,286525
GUJARAT,The Dangs,118257,61329,56928,88038,30219,110034,64561,40486,1172,12038
GUJARAT,Navsari,591834,407881,183953,510004,81830,737838,112809,206608,7173,265244
GUJARAT,Valsad,743245,516188,227057,577327,165918,962433,147569,183025,11833,400818
GUJARAT,Surat,2553542,2142819,410723,2405288,148254,3527780,109549,325739,42040,2076214
GUJARAT,Tapi,450902,251049,199853,337579,113323,356120,105726,254786,9679,80711
DAMAN AND DIU,Diu,15750,12932,2818,14718,1032,36324,471,291,275,14713
DAMAN AND DIU,Daman,105521,94502,11019,101717,3804,85652,1845,481,409,102786
DADRA AND NAGAR HAVELI,Dadra AND Nagar Haveli,157161,119293,37868,130299,26862,186548,28164,17799,2195,109003
MAHARASHTRA,Nandurbar,792065,442898,349167,664193,127872,856230,211672,438176,14599,127618
MAHARASHTRA,Dhule,936370,570448,365922,825875,110495,1114492,239139,429536,20646,247049
MAHARASHTRA,Jalgaon,1863571,1186472,677099,1643955,219616,2366346,384359,937174,38930,503108
MAHARASHTRA,Buldana,1219641,734024,485617,1107542,112099,1366617,385447,603227,13770,217197
MAHARASHTRA,Akola,768154,520362,247792,691025,77129,1045752,129680,388521,9660,240293
MAHARASHTRA,Washim,569792,340353,229439,502755,67037,627368,165598,310195,7122,86877
MAHARASHTRA,Amravati,1236322,837577,398745,1061544,174778,1652123,198793,667943,20998,348588
MAHARASHTRA,Wardha,608235,392316,215919,529623,78612,692539,132989,282170,13785,179291
MAHARASHTRA,Nagpur,1868560,1334211,534349,1654778,213782,2785010,206606,423587,52419,1185948
MAHARASHTRA,Bhandara,597305,345054,252251,413838,183467,603029,123099,312183,17169,144854
MAHARASHTRA,Gondiya,665419,383151,282268,433962,231457,657088,186509,281414,32525,164971
MAHARASHTRA,Gadchiroli,584237,323338,260899,392886,191351,488705,225358,247813,11321,99745
MAHARASHTRA,Chandrapur,1058172,648565,409607,804433,253739,1146135,220978,473983,21346,341865
MAHARASHTRA,Yavatmal,1355999,815475,540524,1195100,160899,1416349,333504,739718,17899,264878
MAHARASHTRA,Nanded,1493953,925232,568721,1317791,176162,1867339,447823,632395,29158,384577
MAHARASHTRA,Hingoli,569182,330903,238279,514371,54811,608163,241613,226483,8268,92818
MAHARASHTRA,Parbhani,822797,501422,321375,756417,66380,1013289,295030,317806,13210,196751
MAHARASHTRA,Jalna,930886,545030,385856,844492,86394,1028160,418952,300937,16705,194292
MAHARASHTRA,Aurangabad,1575079,1015864,559215,1446636,128443,2126203,554518,396630,28033,595898
MAHARASHTRA,Nashik,2763328,1746286,1017042,2523023,240305,3343859,967385,730228,56132,1009583
MAHARASHTRA,Thane,4492767,3363123,1129644,3930511,562256,6567381,349931,418004,124461,3600371
MAHARASHTRA,Mumbai Suburban,3735021,2944322,790699,3515922,219099,5621941,16086,20722,118816,3579397
MAHARASHTRA,Mumbai,1284396,1021009,263387,1209334,75062,1801015,6051,5745,45538,1227062
MAHARASHTRA,Raigarh,1072969,753843,319126,858825,214144,1561231,206975,191182,32919,641893
MAHARASHTRA,Pune,4048993,2809816,1239177,3751221,297772,5380415,886530,414461,105711,2642291
MAHARASHTRA,Ahmadnagar,2204590,1300309,904281,2039455,165135,2338569,1013050,559009,57156,575375
MAHARASHTRA,Bid,1255548,727819,527729,1154708,100840,1329501,606280,373566,21093,254609
MAHARASHTRA,Latur,1046857,670018,376839,964177,82680,1407339,331780,416578,17663,280836
MAHARASHTRA,Osmanabad,773916,473795,300121,701894,72022,883660,297361,299525,19831,157199
MAHARASHTRA,Solapur,1898395,1206933,691462,1763175,135220,2419361,637250,558334,71106,631705
MAHARASHTRA,Satara,1354947,844805,510142,1184407,170540,1648794,585876,297241,39772,432058
MAHARASHTRA,Ratnagiri,714076,407008,307068,554973,159103,900993,296913,153117,17230,246816
MAHARASHTRA,Sindhudurg,347178,229676,117502,226538,120640,502473,124812,81816,9679,130871
MAHARASHTRA,Kolhapur,1704054,1125204,578850,1508563,195491,2171947,660872,266028,59932,717222
MAHARASHTRA,Sangli,1215104,800214,414890,1074948,140156,1607039,480554,290693,40824,403033
ANDHRA PRADESH,Adilabad,1323667,748939,574728,1066460,257207,1417572,363737,484912,84661,390357
ANDHRA PRADESH,Nizamabad,1261076,684320,576756,1055965,205111,1290259,278102,448281,171311,363382
ANDHRA PRADESH,Karimnagar,1876768,1049463,827305,1590304,286464,1899501,360390,756859,168340,591179
ANDHRA PRADESH,Medak,1442203,837874,604329,1195494,246709,1591085,353221,571129,67642,450211
ANDHRA PRADESH,Hyderabad,1413297,1045585,367712,1096081,317216,2530026,28308,23029,46157,1315803
ANDHRA PRADESH,Rangareddy,2196078,1488916,707162,1834777,361301,3100663,270925,349032,73387,1502734
ANDHRA PRADESH,Mahbubnagar,2082501,1140067,942434,1815643,266858,1970527,569142,931084,57846,524429
ANDHRA PRADESH,Nalgonda,1741693,976428,765265,1493419,248274,1747116,325224,863131,45124,508214
ANDHRA PRADESH,Warangal,1705655,960926,744729,1442197,263458,1806921,401646,758092,43550,502367
ANDHRA PRADESH,Khammam,1410062,802906,607156,1215871,194191,1387308,224972,804537,19799,360754
ANDHRA PRADESH,Srikakulam,1290288,766483,523805,936244,354044,1412826,165317,700833,34479,389659
ANDHRA PRADESH,Vizianagaram,1157962,679289,478673,953215,204747,1186512,212285,557254,27469,360954
ANDHRA PRADESH,Visakhapatnam,1889879,1239064,650815,1481139,408740,2400710,322164,578949,54545,934221
ANDHRA PRADESH,East Godavari,2093681,1545831,547850,1748117,345564,3060615,160407,1122046,57853,753375
ANDHRA PRADESH,West Godavari,1773112,1199338,573774,1534166,238946,2163854,155275,1061787,33861,522189
ANDHRA PRADESH,Krishna,2048880,1327299,721581,1744978,303902,2468518,150166,1006976,48444,843294
ANDHRA PRADESH,Guntur,2381624,1442370,939254,2106326,275298,2506189,302341,1227956,47436,803891
ANDHRA PRADESH,Prakasam,1700567,991842,708725,1463508,237059,1696881,280029,889218,42603,488717
ANDHRA PRADESH,Sri Potti Sriramulu Nellore,1314561,859880,454681,1076544,238017,1648996,165513,625262,35403,488383
ANDHRA PRADESH,Y.S.R.,1320404,823886,496518,1079903,240501,1562065,243607,542455,55824,478518
ANDHRA PRADESH,Kurnool,2029425,1164122,865303,1757520,271905,2024038,310954,1037302,60791,620378
ANDHRA PRADESH,Anantapur,2036166,1208544,827622,1679655,356511,2044982,413253,879537,105343,638033
ANDHRA PRADESH,Chittoor,1933357,1202223,731134,1669852,263505,2240707,434544,748093,57269,693451
KARNATAKA,Belgaum,2105668,1372422,733246,1734501,371167,2673993,711980,649517,60342,683829
KARNATAKA,Bagalkot,818081,511575,306506,676407,141674,1071671,196199,303243,44797,273842
KARNATAKA,Bijapur,927722,580111,347611,760083,167639,1249609,262217,351600,25379,288526
KARNATAKA,Bidar,702608,459050,243558,551763,150845,1000692,141302,280091,18095,263120
KARNATAKA,Raichur,903413,530373,373040,725985,177428,1025399,245299,383526,19095,255493
KARNATAKA,Koppal,654766,387974,266792,508089,146677,735154,163413,273016,18794,199543
KARNATAKA,Gadag,495722,310412,185310,423451,72271,568848,127441,200310,15485,152486
KARNATAKA,Dharwad,784833,543776,241057,690948,93885,1062190,164279,207642,16463,396449
KARNATAKA,Uttara Kannada,608526,430565,177961,498304,110222,828643,111581,116336,9492,371117
KARNATAKA,Haveri,730066,490731,239335,601951,128115,867602,203055,311263,20217,195531
KARNATAKA,Bellary,1116880,703258,413622,969388,147492,1335715,258080,406092,22832,429876
KARNATAKA,Chitradurga,856587,513311,343276,667479,189108,802869,286245,294337,26235,249770
KARNATAKA,Davanagere,875207,585639,289568,705099,170108,1070290,230846,295873,31438,317050
KARNATAKA,Shimoga,780598,534487,246111,652789,127809,972155,204493,246464,15087,314554
KARNATAKA,Udupi,513241,335399,177842,459446,53795,664120,63143,63390,10580,376128
KARNATAKA,Chikmagalur,565774,357889,207885,480229,85545,572187,155392,126600,8873,274909
KARNATAKA,Tumkur,1354646,837512,517134,1078431,276215,1324334,505910,352286,54523,441927
KARNATAKA,Bangalore,4246927,3115361,1131566,3858342,388585,5374624,95619,97914,108898,3944496
KARNATAKA,Mandya,871408,575203,296205,714901,156507,934361,388981,216159,17834,248434
KARNATAKA,Hassan,903580,560452,343128,752387,151193,872841,437034,165910,16126,284510
KARNATAKA,Dakshina Kannada,997721,620903,376818,914476,83245,1091928,33810,29274,188207,746430
KARNATAKA,Kodagu,278938,172100,106838,258753,20185,275581,21174,15153,1549,241062
KARNATAKA,Mysore,1314268,921803,392465,1082108,232160,1686859,349337,311002,28162,625767
KARNATAKA,Chamarajanagar,481693,324326,157367,381408,100285,539098,113105,214303,14007,140278
KARNATAKA,Gulbarga,1087028,680001,407027,844237,242791,1479298,220198,415267,25891,425672
KARNATAKA,Yadgir,547696,317135,230561,437241,110455,626575,159333,234655,13192,140516
KARNATAKA,Kolar,717872,454048,263824,584590,133282,818529,183057,201233,24178,309404
KARNATAKA,Chikkaballapura,639778,384452,255326,535565,104213,615326,212226,206939,20276,200337
KARNATAKA,Bangalore Rural,459891,315499,144392,389989,69902,531032,127770,84108,19457,228556
KARNATAKA,Ramanagara,531459,344349,187110,458841,72618,551177,208130,102460,17723,203146
GOA,North Goa,327658,239125,88533,269437,58221,490350,15402,14120,8862,289274
GOA,South Goa,249590,180411,69179,206616,42974,390947,15952,12640,5846,215152
LAKSHADWEEP,Lakshadweep,18753,15318,3435,10804,7949,45720,0,0,264,18489
KERALA,Kasaragod,462998,325095,137903,372700,90298,844377,23732,38774,24496,375996
KERALA,Kannur,824116,609377,214739,694209,129907,1698887,36549,82988,12875,691704
KERALA,Wayanad,340077,228639,111438,263445,76632,477343,52759,101630,4574,181114
KERALA,Kozhikode,948981,752333,196648,754187,194794,2137312,26543,64198,13312,844928
KERALA,Malappuram,1062424,898157,164267,852047,210377,3050496,57567,117405,18423,869029
KERALA,Palakkad,1042340,746121,296219,875540,166800,1767594,67805,249949,25035,699551
KERALA,Thrissur,1095727,789511,306216,929506,166221,2025473,41786,73941,27883,952117
KERALA,Ernakulam,1249343,913249,336094,1061388,187955,2033045,50423,71391,23976,1103553
KERALA,Idukki,516363,331710,184653,415947,100416,592611,100917,145698,6888,262860
KERALA,Kottayam,735735,530322,205413,604553,131182,1238816,49991,63052,18523,604169
KERALA,Alappuzha,804471,536738,267733,596387,208084,1323318,25237,71706,35865,671663
KERALA,Pathanamthitta,392794,281854,110940,293257,99537,804618,41414,55455,11074,284851
KERALA,Kollam,912025,644362,267663,695299,216726,1723350,56693,92193,21511,741628
KERALA,Thiruvananthapuram,1231669,864101,367568,921282,310387,2069758,38837,94470,28587,1069775
TAMIL NADU,Thiruvallur,1538054,1103563,434491,1247918,290136,2190050,73444,270586,58240,1135784
TAMIL NADU,Chennai,1817297,1369302,447995,1619554,197743,2829435,14454,13674,37345,1751824
TAMIL NADU,Kancheepuram,1673814,1181308,492506,1367378,306436,2324438,89343,272514,54732,1257225
TAMIL NADU,Vellore,1689330,1123874,565456,1360185,329145,2247001,175108,391955,136415,985852
TAMIL NADU,Tiruvannamalai,1238177,738995,499182,970072,268105,1226698,292641,525063,46720,373753
TAMIL NADU,Viluppuram,1703249,1017383,685866,1260802,442447,1755624,369646,832213,38237,463153
TAMIL NADU,Salem,1694160,1083797,610363,1561030,133130,1787896,257004,454210,141503,841443
TAMIL NADU,Namakkal,898245,531463,366782,839152,59093,828356,158473,253726,38797,447249
TAMIL NADU,Erode,1195773,732083,463690,1111051,84722,1055971,178170,370212,54322,593069
TAMIL NADU,The Nilgiris,349974,212172,137802,318924,31050,385420,15645,79100,3895,251334
TAMIL NADU,Dindigul,1105155,665469,439686,963017,142138,1054620,165405,467959,30829,440962
TAMIL NADU,Karur,543298,329034,214264,508507,34791,521195,85872,200837,11340,245249
TAMIL NADU,Tiruchirappalli,1213979,789206,424773,1082329,131650,1508311,170669,378782,30386,634142
TAMIL NADU,Perambalur,299726,162639,137087,255097,44629,265497,117304,118278,5343,58801
TAMIL NADU,Ariyalur,359851,212547,147304,272241,87610,395043,107312,166837,13564,72138
TAMIL NADU,Cuddalore,1169880,749633,420247,837271,332609,1436034,165170,539412,32027,433271
TAMIL NADU,Nagapattinam,671994,461174,210820,486328,185666,944456,67482,345057,11555,247900
TAMIL NADU,Thiruvarur,540168,369853,170315,412425,127743,724109,69883,295188,10440,164657
TAMIL NADU,Thanjavur,974079,680483,293596,834484,139595,1431811,129913,415361,31200,397605
TAMIL NADU,Pudukkottai,761693,471099,290594,640248,121445,856652,209270,305149,13941,233333
TAMIL NADU,Sivaganga,620171,391305,228866,461102,159069,718930,141003,199563,14656,264949
TAMIL NADU,Madurai,1354632,902704,451928,1173902,180730,1683620,92719,372828,47293,841792
TAMIL NADU,Theni,591642,368900,222742,530591,61051,654257,38367,315161,14939,223175
TAMIL NADU,Virudhunagar,950158,579111,371047,854066,96092,992130,57153,208702,35298,649005
TAMIL NADU,Ramanathapuram,602977,392751,210226,486150,116827,750468,173767,153874,25228,250108
TAMIL NADU,Thoothukkudi,748095,503727,244368,657447,90648,1002081,48515,200644,22863,476073
TAMIL NADU,Tirunelveli,1436454,876175,560279,1271407,165047,1640779,115715,379763,239664,701312
TAMIL NADU,Kanniyakumari,679620,524629,154991,552658,126962,1190754,15610,72867,35789,555354
TAMIL NADU,Dharmapuri,751170,446057,305113,652996,98174,755673,201328,267345,15341,267156
TAMIL NADU,Krishnagiri,877779,561634,316145,742001,135778,1002030,236038,263328,21918,356495
TAMIL NADU,Coimbatore,1567950,1083125,484825,1443252,124698,1890095,80217,230026,50085,1207622
TAMIL NADU,Tiruppur,1266137,819783,446354,1168596,97541,1212915,135817,246333,40988,842999
PONDICHERRY,Yanam,16760,14047,2713,15373,1387,38866,291,3324,146,12999
PONDICHERRY,PONDICHERRY,348105,256652,91453,315570,32535,602184,9393,51908,6350,280454
PONDICHERRY,Mahe,11802,9093,2709,10404,1398,30014,43,82,69,11608
PONDICHERRY,Karaikal,68301,53139,15162,58342,9959,131921,2372,13077,1327,51525
ANDAMAN AND NICOBAR ISLANDS,Nicobars,17125,12714,4411,9651,7474,19717,322,242,2560,14001
ANDAMAN AND NICOBAR ISLANDS,North  AND Middle Andaman,38579,30612,7967,31038,7541,67018,10727,1915,260,25677
ANDAMAN AND NICOBAR ISLANDS,South Andaman,96831,77563,19268,85221,11610,141311,5518,2624,907,87782
